filename,r,c,x_min,y_min,x_max,y_max,width,height
cell_r0_c0.png,0,0,1,1,18,118,17,117
cell_r0_c1.png,0,1,17,1,230,119,213,118
cell_r0_c2.png,0,2,229,1,280,119,51,118
cell_r0_c3.png,0,3,280,1,324,119,44,118
cell_r0_c4.png,0,4,324,1,1050,24,726,23
cell_r0_c0.png,0,0,1,1,18,118,17,117
cell_r0_c1.png,0,1,17,1,230,119,213,118
cell_r0_c2.png,0,2,229,1,280,119,51,118
cell_r0_c3.png,0,3,280,1,324,119,44,118
cell_r0_c4.png,0,4,324,1,1050,24,726,23
cell_r0_c0.png,0,0,1,1,18,118,17,117
cell_r0_c1.png,0,1,17,1,230,119,213,118
cell_r0_c2.png,0,2,229,1,280,119,51,118
cell_r0_c3.png,0,3,280,1,324,119,44,118
cell_r0_c4.png,0,4,324,1,1050,24,726,23
cell_r0_c0.png,0,0,1,1,18,118,17,117
cell_r0_c1.png,0,1,17,1,230,119,213,118
cell_r0_c2.png,0,2,229,1,280,119,51,118
cell_r0_c3.png,0,3,280,1,324,119,44,118
cell_r0_c4.png,0,4,324,1,1050,24,726,23
cell_r0_c0.png,0,0,1,1,18,118,17,117
cell_r0_c1.png,0,1,17,1,230,119,213,118
cell_r0_c2.png,0,2,229,1,280,119,51,118
cell_r0_c3.png,0,3,280,1,324,119,44,118
cell_r0_c4.png,0,4,324,1,1050,24,726,23
cell_r1_c0.png,1,0,324,24,503,36,179,12
cell_r1_c1.png,1,1,502,24,698,36,196,12
cell_r1_c2.png,1,2,698,24,886,36,188,12
cell_r1_c3.png,1,3,886,24,919,119,33,95
cell_r1_c4.png,1,4,918,24,985,120,67,96
cell_r1_c5.png,1,5,984,24,1050,120,66,96
cell_r1_c0.png,1,0,324,24,503,36,179,12
cell_r1_c1.png,1,1,502,24,698,36,196,12
cell_r1_c2.png,1,2,698,24,886,36,188,12
cell_r1_c3.png,1,3,886,24,919,119,33,95
cell_r1_c4.png,1,4,918,24,985,120,67,96
cell_r1_c5.png,1,5,984,24,1050,120,66,96
cell_r1_c0.png,1,0,324,24,503,36,179,12
cell_r1_c1.png,1,1,502,24,698,36,196,12
cell_r1_c2.png,1,2,698,24,886,36,188,12
cell_r1_c3.png,1,3,886,24,919,119,33,95
cell_r1_c4.png,1,4,918,24,985,120,67,96
cell_r1_c5.png,1,5,984,24,1050,120,66,96
cell_r1_c0.png,1,0,324,24,503,36,179,12
cell_r1_c1.png,1,1,502,24,698,36,196,12
cell_r1_c2.png,1,2,698,24,886,36,188,12
cell_r1_c3.png,1,3,886,24,919,119,33,95
cell_r1_c4.png,1,4,918,24,985,120,67,96
cell_r1_c5.png,1,5,984,24,1050,120,66,96
cell_r1_c0.png,1,0,324,24,503,36,179,12
cell_r1_c1.png,1,1,502,24,698,36,196,12
cell_r1_c2.png,1,2,698,24,886,36,188,12
cell_r1_c3.png,1,3,886,24,919,119,33,95
cell_r1_c4.png,1,4,918,24,985,120,67,96
cell_r1_c5.png,1,5,984,24,1050,120,66,96
cell_r1_c0.png,1,0,324,24,503,36,179,12
cell_r1_c1.png,1,1,502,24,698,36,196,12
cell_r1_c2.png,1,2,698,24,886,36,188,12
cell_r1_c3.png,1,3,886,24,919,119,33,95
cell_r1_c4.png,1,4,918,24,985,120,67,96
cell_r1_c5.png,1,5,984,24,1050,120,66,96
cell_r2_c0.png,2,0,324,36,360,119,36,83
cell_r2_c1.png,2,1,359,36,391,119,32,83
cell_r2_c2.png,2,2,391,36,446,119,55,83
cell_r2_c3.png,2,3,446,36,502,119,56,83
cell_r2_c4.png,2,4,502,36,538,119,36,83
cell_r2_c5.png,2,5,538,36,570,119,32,83
cell_r2_c6.png,2,6,570,36,626,120,56,84
cell_r2_c7.png,2,7,626,36,698,120,72,84
cell_r2_c8.png,2,8,698,36,734,120,36,84
cell_r2_c9.png,2,9,734,36,766,119,32,83
cell_r2_c10.png,2,10,766,36,822,120,56,84
cell_r2_c11.png,2,11,821,36,887,120,66,84
cell_r2_c0.png,2,0,324,36,360,119,36,83
cell_r2_c1.png,2,1,359,36,391,119,32,83
cell_r2_c2.png,2,2,391,36,446,119,55,83
cell_r2_c3.png,2,3,446,36,502,119,56,83
cell_r2_c4.png,2,4,502,36,538,119,36,83
cell_r2_c5.png,2,5,538,36,570,119,32,83
cell_r2_c6.png,2,6,570,36,626,120,56,84
cell_r2_c7.png,2,7,626,36,698,120,72,84
cell_r2_c8.png,2,8,698,36,734,120,36,84
cell_r2_c9.png,2,9,734,36,766,119,32,83
cell_r2_c10.png,2,10,766,36,822,120,56,84
cell_r2_c11.png,2,11,821,36,887,120,66,84
cell_r2_c0.png,2,0,324,36,360,119,36,83
cell_r2_c1.png,2,1,359,36,391,119,32,83
cell_r2_c2.png,2,2,391,36,446,119,55,83
cell_r2_c3.png,2,3,446,36,502,119,56,83
cell_r2_c4.png,2,4,502,36,538,119,36,83
cell_r2_c5.png,2,5,538,36,570,119,32,83
cell_r2_c6.png,2,6,570,36,626,120,56,84
cell_r2_c7.png,2,7,626,36,698,120,72,84
cell_r2_c8.png,2,8,698,36,734,120,36,84
cell_r2_c9.png,2,9,734,36,766,119,32,83
cell_r2_c10.png,2,10,766,36,822,120,56,84
cell_r2_c11.png,2,11,821,36,887,120,66,84
cell_r2_c0.png,2,0,324,36,360,119,36,83
cell_r2_c1.png,2,1,359,36,391,119,32,83
cell_r2_c2.png,2,2,391,36,446,119,55,83
cell_r2_c3.png,2,3,446,36,502,119,56,83
cell_r2_c4.png,2,4,502,36,538,119,36,83
cell_r2_c5.png,2,5,538,36,570,119,32,83
cell_r2_c6.png,2,6,570,36,626,120,56,84
cell_r2_c7.png,2,7,626,36,698,120,72,84
cell_r2_c8.png,2,8,698,36,734,120,36,84
cell_r2_c9.png,2,9,734,36,766,119,32,83
cell_r2_c10.png,2,10,766,36,822,120,56,84
cell_r2_c11.png,2,11,821,36,887,120,66,84
cell_r2_c0.png,2,0,324,36,360,119,36,83
cell_r2_c1.png,2,1,359,36,391,119,32,83
cell_r2_c2.png,2,2,391,36,446,119,55,83
cell_r2_c3.png,2,3,446,36,502,119,56,83
cell_r2_c4.png,2,4,502,36,538,119,36,83
cell_r2_c5.png,2,5,538,36,570,119,32,83
cell_r2_c6.png,2,6,570,36,626,120,56,84
cell_r2_c7.png,2,7,626,36,698,120,72,84
cell_r2_c8.png,2,8,698,36,734,120,36,84
cell_r2_c9.png,2,9,734,36,766,119,32,83
cell_r2_c10.png,2,10,766,36,822,120,56,84
cell_r2_c11.png,2,11,821,36,887,120,66,84
cell_r2_c0.png,2,0,324,36,360,119,36,83
cell_r2_c1.png,2,1,359,36,391,119,32,83
cell_r2_c2.png,2,2,391,36,446,119,55,83
cell_r2_c3.png,2,3,446,36,502,119,56,83
cell_r2_c4.png,2,4,502,36,538,119,36,83
cell_r2_c5.png,2,5,538,36,570,119,32,83
cell_r2_c6.png,2,6,570,36,626,120,56,84
cell_r2_c7.png,2,7,626,36,698,120,72,84
cell_r2_c8.png,2,8,698,36,734,120,36,84
cell_r2_c9.png,2,9,734,36,766,119,32,83
cell_r2_c10.png,2,10,766,36,822,120,56,84
cell_r2_c11.png,2,11,821,36,887,120,66,84
cell_r2_c0.png,2,0,324,36,360,119,36,83
cell_r2_c1.png,2,1,359,36,391,119,32,83
cell_r2_c2.png,2,2,391,36,446,119,55,83
cell_r2_c3.png,2,3,446,36,502,119,56,83
cell_r2_c4.png,2,4,502,36,538,119,36,83
cell_r2_c5.png,2,5,538,36,570,119,32,83
cell_r2_c6.png,2,6,570,36,626,120,56,84
cell_r2_c7.png,2,7,626,36,698,120,72,84
cell_r2_c8.png,2,8,698,36,734,120,36,84
cell_r2_c9.png,2,9,734,36,766,119,32,83
cell_r2_c10.png,2,10,766,36,822,120,56,84
cell_r2_c11.png,2,11,821,36,887,120,66,84
cell_r2_c0.png,2,0,324,36,360,119,36,83
cell_r2_c1.png,2,1,359,36,391,119,32,83
cell_r2_c2.png,2,2,391,36,446,119,55,83
cell_r2_c3.png,2,3,446,36,502,119,56,83
cell_r2_c4.png,2,4,502,36,538,119,36,83
cell_r2_c5.png,2,5,538,36,570,119,32,83
cell_r2_c6.png,2,6,570,36,626,120,56,84
cell_r2_c7.png,2,7,626,36,698,120,72,84
cell_r2_c8.png,2,8,698,36,734,120,36,84
cell_r2_c9.png,2,9,734,36,766,119,32,83
cell_r2_c10.png,2,10,766,36,822,120,56,84
cell_r2_c11.png,2,11,821,36,887,120,66,84
cell_r2_c0.png,2,0,324,36,360,119,36,83
cell_r2_c1.png,2,1,359,36,391,119,32,83
cell_r2_c2.png,2,2,391,36,446,119,55,83
cell_r2_c3.png,2,3,446,36,502,119,56,83
cell_r2_c4.png,2,4,502,36,538,119,36,83
cell_r2_c5.png,2,5,538,36,570,119,32,83
cell_r2_c6.png,2,6,570,36,626,120,56,84
cell_r2_c7.png,2,7,626,36,698,120,72,84
cell_r2_c8.png,2,8,698,36,734,120,36,84
cell_r2_c9.png,2,9,734,36,766,119,32,83
cell_r2_c10.png,2,10,766,36,822,120,56,84
cell_r2_c11.png,2,11,821,36,887,120,66,84
cell_r2_c0.png,2,0,324,36,360,119,36,83
cell_r2_c1.png,2,1,359,36,391,119,32,83
cell_r2_c2.png,2,2,391,36,446,119,55,83
cell_r2_c3.png,2,3,446,36,502,119,56,83
cell_r2_c4.png,2,4,502,36,538,119,36,83
cell_r2_c5.png,2,5,538,36,570,119,32,83
cell_r2_c6.png,2,6,570,36,626,120,56,84
cell_r2_c7.png,2,7,626,36,698,120,72,84
cell_r2_c8.png,2,8,698,36,734,120,36,84
cell_r2_c9.png,2,9,734,36,766,119,32,83
cell_r2_c10.png,2,10,766,36,822,120,56,84
cell_r2_c11.png,2,11,821,36,887,120,66,84
cell_r2_c0.png,2,0,324,36,360,119,36,83
cell_r2_c1.png,2,1,359,36,391,119,32,83
cell_r2_c2.png,2,2,391,36,446,119,55,83
cell_r2_c3.png,2,3,446,36,502,119,56,83
cell_r2_c4.png,2,4,502,36,538,119,36,83
cell_r2_c5.png,2,5,538,36,570,119,32,83
cell_r2_c6.png,2,6,570,36,626,120,56,84
cell_r2_c7.png,2,7,626,36,698,120,72,84
cell_r2_c8.png,2,8,698,36,734,120,36,84
cell_r2_c9.png,2,9,734,36,766,119,32,83
cell_r2_c10.png,2,10,766,36,822,120,56,84
cell_r2_c11.png,2,11,821,36,887,120,66,84
cell_r2_c0.png,2,0,324,36,360,119,36,83
cell_r2_c1.png,2,1,359,36,391,119,32,83
cell_r2_c2.png,2,2,391,36,446,119,55,83
cell_r2_c3.png,2,3,446,36,502,119,56,83
cell_r2_c4.png,2,4,502,36,538,119,36,83
cell_r2_c5.png,2,5,538,36,570,119,32,83
cell_r2_c6.png,2,6,570,36,626,120,56,84
cell_r2_c7.png,2,7,626,36,698,120,72,84
cell_r2_c8.png,2,8,698,36,734,120,36,84
cell_r2_c9.png,2,9,734,36,766,119,32,83
cell_r2_c10.png,2,10,766,36,822,120,56,84
cell_r2_c11.png,2,11,821,36,887,120,66,84
cell_r3_c0.png,3,0,1,118,17,126,16,8
cell_r3_c1.png,3,1,17,118,229,127,212,9
cell_r3_c2.png,3,2,229,118,280,127,51,9
cell_r3_c3.png,3,3,280,118,324,127,44,9
cell_r3_c4.png,3,4,324,119,359,127,35,8
cell_r3_c5.png,3,5,359,119,391,127,32,8
cell_r3_c6.png,3,6,391,119,446,127,55,8
cell_r3_c7.png,3,7,446,119,502,127,56,8
cell_r3_c8.png,3,8,502,119,538,127,36,8
cell_r3_c9.png,3,9,538,119,570,127,32,8
cell_r3_c10.png,3,10,570,119,626,127,56,8
cell_r3_c11.png,3,11,626,120,698,127,72,7
cell_r3_c12.png,3,12,698,119,734,127,36,8
cell_r3_c13.png,3,13,734,119,766,127,32,8
cell_r3_c14.png,3,14,766,119,822,128,56,9
cell_r3_c15.png,3,15,822,119,887,128,65,9
cell_r3_c16.png,3,16,887,119,919,127,32,8
cell_r3_c17.png,3,17,919,119,985,128,66,9
cell_r3_c18.png,3,18,985,119,1050,128,65,9
cell_r3_c0.png,3,0,1,118,17,126,16,8
cell_r3_c1.png,3,1,17,118,229,127,212,9
cell_r3_c2.png,3,2,229,118,280,127,51,9
cell_r3_c3.png,3,3,280,118,324,127,44,9
cell_r3_c4.png,3,4,324,119,359,127,35,8
cell_r3_c5.png,3,5,359,119,391,127,32,8
cell_r3_c6.png,3,6,391,119,446,127,55,8
cell_r3_c7.png,3,7,446,119,502,127,56,8
cell_r3_c8.png,3,8,502,119,538,127,36,8
cell_r3_c9.png,3,9,538,119,570,127,32,8
cell_r3_c10.png,3,10,570,119,626,127,56,8
cell_r3_c11.png,3,11,626,120,698,127,72,7
cell_r3_c12.png,3,12,698,119,734,127,36,8
cell_r3_c13.png,3,13,734,119,766,127,32,8
cell_r3_c14.png,3,14,766,119,822,128,56,9
cell_r3_c15.png,3,15,822,119,887,128,65,9
cell_r3_c16.png,3,16,887,119,919,127,32,8
cell_r3_c17.png,3,17,919,119,985,128,66,9
cell_r3_c18.png,3,18,985,119,1050,128,65,9
cell_r3_c0.png,3,0,1,118,17,126,16,8
cell_r3_c1.png,3,1,17,118,229,127,212,9
cell_r3_c2.png,3,2,229,118,280,127,51,9
cell_r3_c3.png,3,3,280,118,324,127,44,9
cell_r3_c4.png,3,4,324,119,359,127,35,8
cell_r3_c5.png,3,5,359,119,391,127,32,8
cell_r3_c6.png,3,6,391,119,446,127,55,8
cell_r3_c7.png,3,7,446,119,502,127,56,8
cell_r3_c8.png,3,8,502,119,538,127,36,8
cell_r3_c9.png,3,9,538,119,570,127,32,8
cell_r3_c10.png,3,10,570,119,626,127,56,8
cell_r3_c11.png,3,11,626,120,698,127,72,7
cell_r3_c12.png,3,12,698,119,734,127,36,8
cell_r3_c13.png,3,13,734,119,766,127,32,8
cell_r3_c14.png,3,14,766,119,822,128,56,9
cell_r3_c15.png,3,15,822,119,887,128,65,9
cell_r3_c16.png,3,16,887,119,919,127,32,8
cell_r3_c17.png,3,17,919,119,985,128,66,9
cell_r3_c18.png,3,18,985,119,1050,128,65,9
cell_r3_c0.png,3,0,1,118,17,126,16,8
cell_r3_c1.png,3,1,17,118,229,127,212,9
cell_r3_c2.png,3,2,229,118,280,127,51,9
cell_r3_c3.png,3,3,280,118,324,127,44,9
cell_r3_c4.png,3,4,324,119,359,127,35,8
cell_r3_c5.png,3,5,359,119,391,127,32,8
cell_r3_c6.png,3,6,391,119,446,127,55,8
cell_r3_c7.png,3,7,446,119,502,127,56,8
cell_r3_c8.png,3,8,502,119,538,127,36,8
cell_r3_c9.png,3,9,538,119,570,127,32,8
cell_r3_c10.png,3,10,570,119,626,127,56,8
cell_r3_c11.png,3,11,626,120,698,127,72,7
cell_r3_c12.png,3,12,698,119,734,127,36,8
cell_r3_c13.png,3,13,734,119,766,127,32,8
cell_r3_c14.png,3,14,766,119,822,128,56,9
cell_r3_c15.png,3,15,822,119,887,128,65,9
cell_r3_c16.png,3,16,887,119,919,127,32,8
cell_r3_c17.png,3,17,919,119,985,128,66,9
cell_r3_c18.png,3,18,985,119,1050,128,65,9
cell_r3_c0.png,3,0,1,118,17,126,16,8
cell_r3_c1.png,3,1,17,118,229,127,212,9
cell_r3_c2.png,3,2,229,118,280,127,51,9
cell_r3_c3.png,3,3,280,118,324,127,44,9
cell_r3_c4.png,3,4,324,119,359,127,35,8
cell_r3_c5.png,3,5,359,119,391,127,32,8
cell_r3_c6.png,3,6,391,119,446,127,55,8
cell_r3_c7.png,3,7,446,119,502,127,56,8
cell_r3_c8.png,3,8,502,119,538,127,36,8
cell_r3_c9.png,3,9,538,119,570,127,32,8
cell_r3_c10.png,3,10,570,119,626,127,56,8
cell_r3_c11.png,3,11,626,120,698,127,72,7
cell_r3_c12.png,3,12,698,119,734,127,36,8
cell_r3_c13.png,3,13,734,119,766,127,32,8
cell_r3_c14.png,3,14,766,119,822,128,56,9
cell_r3_c15.png,3,15,822,119,887,128,65,9
cell_r3_c16.png,3,16,887,119,919,127,32,8
cell_r3_c17.png,3,17,919,119,985,128,66,9
cell_r3_c18.png,3,18,985,119,1050,128,65,9
cell_r3_c0.png,3,0,1,118,17,126,16,8
cell_r3_c1.png,3,1,17,118,229,127,212,9
cell_r3_c2.png,3,2,229,118,280,127,51,9
cell_r3_c3.png,3,3,280,118,324,127,44,9
cell_r3_c4.png,3,4,324,119,359,127,35,8
cell_r3_c5.png,3,5,359,119,391,127,32,8
cell_r3_c6.png,3,6,391,119,446,127,55,8
cell_r3_c7.png,3,7,446,119,502,127,56,8
cell_r3_c8.png,3,8,502,119,538,127,36,8
cell_r3_c9.png,3,9,538,119,570,127,32,8
cell_r3_c10.png,3,10,570,119,626,127,56,8
cell_r3_c11.png,3,11,626,120,698,127,72,7
cell_r3_c12.png,3,12,698,119,734,127,36,8
cell_r3_c13.png,3,13,734,119,766,127,32,8
cell_r3_c14.png,3,14,766,119,822,128,56,9
cell_r3_c15.png,3,15,822,119,887,128,65,9
cell_r3_c16.png,3,16,887,119,919,127,32,8
cell_r3_c17.png,3,17,919,119,985,128,66,9
cell_r3_c18.png,3,18,985,119,1050,128,65,9
cell_r3_c0.png,3,0,1,118,17,126,16,8
cell_r3_c1.png,3,1,17,118,229,127,212,9
cell_r3_c2.png,3,2,229,118,280,127,51,9
cell_r3_c3.png,3,3,280,118,324,127,44,9
cell_r3_c4.png,3,4,324,119,359,127,35,8
cell_r3_c5.png,3,5,359,119,391,127,32,8
cell_r3_c6.png,3,6,391,119,446,127,55,8
cell_r3_c7.png,3,7,446,119,502,127,56,8
cell_r3_c8.png,3,8,502,119,538,127,36,8
cell_r3_c9.png,3,9,538,119,570,127,32,8
cell_r3_c10.png,3,10,570,119,626,127,56,8
cell_r3_c11.png,3,11,626,120,698,127,72,7
cell_r3_c12.png,3,12,698,119,734,127,36,8
cell_r3_c13.png,3,13,734,119,766,127,32,8
cell_r3_c14.png,3,14,766,119,822,128,56,9
cell_r3_c15.png,3,15,822,119,887,128,65,9
cell_r3_c16.png,3,16,887,119,919,127,32,8
cell_r3_c17.png,3,17,919,119,985,128,66,9
cell_r3_c18.png,3,18,985,119,1050,128,65,9
cell_r3_c0.png,3,0,1,118,17,126,16,8
cell_r3_c1.png,3,1,17,118,229,127,212,9
cell_r3_c2.png,3,2,229,118,280,127,51,9
cell_r3_c3.png,3,3,280,118,324,127,44,9
cell_r3_c4.png,3,4,324,119,359,127,35,8
cell_r3_c5.png,3,5,359,119,391,127,32,8
cell_r3_c6.png,3,6,391,119,446,127,55,8
cell_r3_c7.png,3,7,446,119,502,127,56,8
cell_r3_c8.png,3,8,502,119,538,127,36,8
cell_r3_c9.png,3,9,538,119,570,127,32,8
cell_r3_c10.png,3,10,570,119,626,127,56,8
cell_r3_c11.png,3,11,626,120,698,127,72,7
cell_r3_c12.png,3,12,698,119,734,127,36,8
cell_r3_c13.png,3,13,734,119,766,127,32,8
cell_r3_c14.png,3,14,766,119,822,128,56,9
cell_r3_c15.png,3,15,822,119,887,128,65,9
cell_r3_c16.png,3,16,887,119,919,127,32,8
cell_r3_c17.png,3,17,919,119,985,128,66,9
cell_r3_c18.png,3,18,985,119,1050,128,65,9
cell_r3_c0.png,3,0,1,118,17,126,16,8
cell_r3_c1.png,3,1,17,118,229,127,212,9
cell_r3_c2.png,3,2,229,118,280,127,51,9
cell_r3_c3.png,3,3,280,118,324,127,44,9
cell_r3_c4.png,3,4,324,119,359,127,35,8
cell_r3_c5.png,3,5,359,119,391,127,32,8
cell_r3_c6.png,3,6,391,119,446,127,55,8
cell_r3_c7.png,3,7,446,119,502,127,56,8
cell_r3_c8.png,3,8,502,119,538,127,36,8
cell_r3_c9.png,3,9,538,119,570,127,32,8
cell_r3_c10.png,3,10,570,119,626,127,56,8
cell_r3_c11.png,3,11,626,120,698,127,72,7
cell_r3_c12.png,3,12,698,119,734,127,36,8
cell_r3_c13.png,3,13,734,119,766,127,32,8
cell_r3_c14.png,3,14,766,119,822,128,56,9
cell_r3_c15.png,3,15,822,119,887,128,65,9
cell_r3_c16.png,3,16,887,119,919,127,32,8
cell_r3_c17.png,3,17,919,119,985,128,66,9
cell_r3_c18.png,3,18,985,119,1050,128,65,9
cell_r3_c0.png,3,0,1,118,17,126,16,8
cell_r3_c1.png,3,1,17,118,229,127,212,9
cell_r3_c2.png,3,2,229,118,280,127,51,9
cell_r3_c3.png,3,3,280,118,324,127,44,9
cell_r3_c4.png,3,4,324,119,359,127,35,8
cell_r3_c5.png,3,5,359,119,391,127,32,8
cell_r3_c6.png,3,6,391,119,446,127,55,8
cell_r3_c7.png,3,7,446,119,502,127,56,8
cell_r3_c8.png,3,8,502,119,538,127,36,8
cell_r3_c9.png,3,9,538,119,570,127,32,8
cell_r3_c10.png,3,10,570,119,626,127,56,8
cell_r3_c11.png,3,11,626,120,698,127,72,7
cell_r3_c12.png,3,12,698,119,734,127,36,8
cell_r3_c13.png,3,13,734,119,766,127,32,8
cell_r3_c14.png,3,14,766,119,822,128,56,9
cell_r3_c15.png,3,15,822,119,887,128,65,9
cell_r3_c16.png,3,16,887,119,919,127,32,8
cell_r3_c17.png,3,17,919,119,985,128,66,9
cell_r3_c18.png,3,18,985,119,1050,128,65,9
cell_r3_c0.png,3,0,1,118,17,126,16,8
cell_r3_c1.png,3,1,17,118,229,127,212,9
cell_r3_c2.png,3,2,229,118,280,127,51,9
cell_r3_c3.png,3,3,280,118,324,127,44,9
cell_r3_c4.png,3,4,324,119,359,127,35,8
cell_r3_c5.png,3,5,359,119,391,127,32,8
cell_r3_c6.png,3,6,391,119,446,127,55,8
cell_r3_c7.png,3,7,446,119,502,127,56,8
cell_r3_c8.png,3,8,502,119,538,127,36,8
cell_r3_c9.png,3,9,538,119,570,127,32,8
cell_r3_c10.png,3,10,570,119,626,127,56,8
cell_r3_c11.png,3,11,626,120,698,127,72,7
cell_r3_c12.png,3,12,698,119,734,127,36,8
cell_r3_c13.png,3,13,734,119,766,127,32,8
cell_r3_c14.png,3,14,766,119,822,128,56,9
cell_r3_c15.png,3,15,822,119,887,128,65,9
cell_r3_c16.png,3,16,887,119,919,127,32,8
cell_r3_c17.png,3,17,919,119,985,128,66,9
cell_r3_c18.png,3,18,985,119,1050,128,65,9
cell_r3_c0.png,3,0,1,118,17,126,16,8
cell_r3_c1.png,3,1,17,118,229,127,212,9
cell_r3_c2.png,3,2,229,118,280,127,51,9
cell_r3_c3.png,3,3,280,118,324,127,44,9
cell_r3_c4.png,3,4,324,119,359,127,35,8
cell_r3_c5.png,3,5,359,119,391,127,32,8
cell_r3_c6.png,3,6,391,119,446,127,55,8
cell_r3_c7.png,3,7,446,119,502,127,56,8
cell_r3_c8.png,3,8,502,119,538,127,36,8
cell_r3_c9.png,3,9,538,119,570,127,32,8
cell_r3_c10.png,3,10,570,119,626,127,56,8
cell_r3_c11.png,3,11,626,120,698,127,72,7
cell_r3_c12.png,3,12,698,119,734,127,36,8
cell_r3_c13.png,3,13,734,119,766,127,32,8
cell_r3_c14.png,3,14,766,119,822,128,56,9
cell_r3_c15.png,3,15,822,119,887,128,65,9
cell_r3_c16.png,3,16,887,119,919,127,32,8
cell_r3_c17.png,3,17,919,119,985,128,66,9
cell_r3_c18.png,3,18,985,119,1050,128,65,9
cell_r3_c0.png,3,0,1,118,17,126,16,8
cell_r3_c1.png,3,1,17,118,229,127,212,9
cell_r3_c2.png,3,2,229,118,280,127,51,9
cell_r3_c3.png,3,3,280,118,324,127,44,9
cell_r3_c4.png,3,4,324,119,359,127,35,8
cell_r3_c5.png,3,5,359,119,391,127,32,8
cell_r3_c6.png,3,6,391,119,446,127,55,8
cell_r3_c7.png,3,7,446,119,502,127,56,8
cell_r3_c8.png,3,8,502,119,538,127,36,8
cell_r3_c9.png,3,9,538,119,570,127,32,8
cell_r3_c10.png,3,10,570,119,626,127,56,8
cell_r3_c11.png,3,11,626,120,698,127,72,7
cell_r3_c12.png,3,12,698,119,734,127,36,8
cell_r3_c13.png,3,13,734,119,766,127,32,8
cell_r3_c14.png,3,14,766,119,822,128,56,9
cell_r3_c15.png,3,15,822,119,887,128,65,9
cell_r3_c16.png,3,16,887,119,919,127,32,8
cell_r3_c17.png,3,17,919,119,985,128,66,9
cell_r3_c18.png,3,18,985,119,1050,128,65,9
cell_r3_c0.png,3,0,1,118,17,126,16,8
cell_r3_c1.png,3,1,17,118,229,127,212,9
cell_r3_c2.png,3,2,229,118,280,127,51,9
cell_r3_c3.png,3,3,280,118,324,127,44,9
cell_r3_c4.png,3,4,324,119,359,127,35,8
cell_r3_c5.png,3,5,359,119,391,127,32,8
cell_r3_c6.png,3,6,391,119,446,127,55,8
cell_r3_c7.png,3,7,446,119,502,127,56,8
cell_r3_c8.png,3,8,502,119,538,127,36,8
cell_r3_c9.png,3,9,538,119,570,127,32,8
cell_r3_c10.png,3,10,570,119,626,127,56,8
cell_r3_c11.png,3,11,626,120,698,127,72,7
cell_r3_c12.png,3,12,698,119,734,127,36,8
cell_r3_c13.png,3,13,734,119,766,127,32,8
cell_r3_c14.png,3,14,766,119,822,128,56,9
cell_r3_c15.png,3,15,822,119,887,128,65,9
cell_r3_c16.png,3,16,887,119,919,127,32,8
cell_r3_c17.png,3,17,919,119,985,128,66,9
cell_r3_c18.png,3,18,985,119,1050,128,65,9
cell_r3_c0.png,3,0,1,118,17,126,16,8
cell_r3_c1.png,3,1,17,118,229,127,212,9
cell_r3_c2.png,3,2,229,118,280,127,51,9
cell_r3_c3.png,3,3,280,118,324,127,44,9
cell_r3_c4.png,3,4,324,119,359,127,35,8
cell_r3_c5.png,3,5,359,119,391,127,32,8
cell_r3_c6.png,3,6,391,119,446,127,55,8
cell_r3_c7.png,3,7,446,119,502,127,56,8
cell_r3_c8.png,3,8,502,119,538,127,36,8
cell_r3_c9.png,3,9,538,119,570,127,32,8
cell_r3_c10.png,3,10,570,119,626,127,56,8
cell_r3_c11.png,3,11,626,120,698,127,72,7
cell_r3_c12.png,3,12,698,119,734,127,36,8
cell_r3_c13.png,3,13,734,119,766,127,32,8
cell_r3_c14.png,3,14,766,119,822,128,56,9
cell_r3_c15.png,3,15,822,119,887,128,65,9
cell_r3_c16.png,3,16,887,119,919,127,32,8
cell_r3_c17.png,3,17,919,119,985,128,66,9
cell_r3_c18.png,3,18,985,119,1050,128,65,9
cell_r3_c0.png,3,0,1,118,17,126,16,8
cell_r3_c1.png,3,1,17,118,229,127,212,9
cell_r3_c2.png,3,2,229,118,280,127,51,9
cell_r3_c3.png,3,3,280,118,324,127,44,9
cell_r3_c4.png,3,4,324,119,359,127,35,8
cell_r3_c5.png,3,5,359,119,391,127,32,8
cell_r3_c6.png,3,6,391,119,446,127,55,8
cell_r3_c7.png,3,7,446,119,502,127,56,8
cell_r3_c8.png,3,8,502,119,538,127,36,8
cell_r3_c9.png,3,9,538,119,570,127,32,8
cell_r3_c10.png,3,10,570,119,626,127,56,8
cell_r3_c11.png,3,11,626,120,698,127,72,7
cell_r3_c12.png,3,12,698,119,734,127,36,8
cell_r3_c13.png,3,13,734,119,766,127,32,8
cell_r3_c14.png,3,14,766,119,822,128,56,9
cell_r3_c15.png,3,15,822,119,887,128,65,9
cell_r3_c16.png,3,16,887,119,919,127,32,8
cell_r3_c17.png,3,17,919,119,985,128,66,9
cell_r3_c18.png,3,18,985,119,1050,128,65,9
cell_r3_c0.png,3,0,1,118,17,126,16,8
cell_r3_c1.png,3,1,17,118,229,127,212,9
cell_r3_c2.png,3,2,229,118,280,127,51,9
cell_r3_c3.png,3,3,280,118,324,127,44,9
cell_r3_c4.png,3,4,324,119,359,127,35,8
cell_r3_c5.png,3,5,359,119,391,127,32,8
cell_r3_c6.png,3,6,391,119,446,127,55,8
cell_r3_c7.png,3,7,446,119,502,127,56,8
cell_r3_c8.png,3,8,502,119,538,127,36,8
cell_r3_c9.png,3,9,538,119,570,127,32,8
cell_r3_c10.png,3,10,570,119,626,127,56,8
cell_r3_c11.png,3,11,626,120,698,127,72,7
cell_r3_c12.png,3,12,698,119,734,127,36,8
cell_r3_c13.png,3,13,734,119,766,127,32,8
cell_r3_c14.png,3,14,766,119,822,128,56,9
cell_r3_c15.png,3,15,822,119,887,128,65,9
cell_r3_c16.png,3,16,887,119,919,127,32,8
cell_r3_c17.png,3,17,919,119,985,128,66,9
cell_r3_c18.png,3,18,985,119,1050,128,65,9
cell_r3_c0.png,3,0,1,118,17,126,16,8
cell_r3_c1.png,3,1,17,118,229,127,212,9
cell_r3_c2.png,3,2,229,118,280,127,51,9
cell_r3_c3.png,3,3,280,118,324,127,44,9
cell_r3_c4.png,3,4,324,119,359,127,35,8
cell_r3_c5.png,3,5,359,119,391,127,32,8
cell_r3_c6.png,3,6,391,119,446,127,55,8
cell_r3_c7.png,3,7,446,119,502,127,56,8
cell_r3_c8.png,3,8,502,119,538,127,36,8
cell_r3_c9.png,3,9,538,119,570,127,32,8
cell_r3_c10.png,3,10,570,119,626,127,56,8
cell_r3_c11.png,3,11,626,120,698,127,72,7
cell_r3_c12.png,3,12,698,119,734,127,36,8
cell_r3_c13.png,3,13,734,119,766,127,32,8
cell_r3_c14.png,3,14,766,119,822,128,56,9
cell_r3_c15.png,3,15,822,119,887,128,65,9
cell_r3_c16.png,3,16,887,119,919,127,32,8
cell_r3_c17.png,3,17,919,119,985,128,66,9
cell_r3_c18.png,3,18,985,119,1050,128,65,9
cell_r3_c0.png,3,0,1,118,17,126,16,8
cell_r3_c1.png,3,1,17,118,229,127,212,9
cell_r3_c2.png,3,2,229,118,280,127,51,9
cell_r3_c3.png,3,3,280,118,324,127,44,9
cell_r3_c4.png,3,4,324,119,359,127,35,8
cell_r3_c5.png,3,5,359,119,391,127,32,8
cell_r3_c6.png,3,6,391,119,446,127,55,8
cell_r3_c7.png,3,7,446,119,502,127,56,8
cell_r3_c8.png,3,8,502,119,538,127,36,8
cell_r3_c9.png,3,9,538,119,570,127,32,8
cell_r3_c10.png,3,10,570,119,626,127,56,8
cell_r3_c11.png,3,11,626,120,698,127,72,7
cell_r3_c12.png,3,12,698,119,734,127,36,8
cell_r3_c13.png,3,13,734,119,766,127,32,8
cell_r3_c14.png,3,14,766,119,822,128,56,9
cell_r3_c15.png,3,15,822,119,887,128,65,9
cell_r3_c16.png,3,16,887,119,919,127,32,8
cell_r3_c17.png,3,17,919,119,985,128,66,9
cell_r3_c18.png,3,18,985,119,1050,128,65,9
cell_r4_c0.png,4,0,1,126,17,140,16,14
cell_r4_c1.png,4,1,17,126,229,140,212,14
cell_r4_c2.png,4,2,229,126,280,140,51,14
cell_r4_c3.png,4,3,280,126,324,140,44,14
cell_r4_c4.png,4,4,324,127,359,140,35,13
cell_r4_c5.png,4,5,359,127,391,141,32,14
cell_r4_c6.png,4,6,391,127,446,141,55,14
cell_r4_c7.png,4,7,446,127,502,141,56,14
cell_r4_c8.png,4,8,502,127,538,141,36,14
cell_r4_c9.png,4,9,538,126,570,141,32,15
cell_r4_c10.png,4,10,570,126,626,140,56,14
cell_r4_c11.png,4,11,626,127,698,141,72,14
cell_r4_c12.png,4,12,698,127,734,141,36,14
cell_r4_c13.png,4,13,734,127,766,141,32,14
cell_r4_c14.png,4,14,766,127,822,141,56,14
cell_r4_c15.png,4,15,822,127,887,141,65,14
cell_r4_c16.png,4,16,887,127,919,141,32,14
cell_r4_c17.png,4,17,919,127,985,141,66,14
cell_r4_c18.png,4,18,985,127,1050,141,65,14
cell_r4_c0.png,4,0,1,126,17,140,16,14
cell_r4_c1.png,4,1,17,126,229,140,212,14
cell_r4_c2.png,4,2,229,126,280,140,51,14
cell_r4_c3.png,4,3,280,126,324,140,44,14
cell_r4_c4.png,4,4,324,127,359,140,35,13
cell_r4_c5.png,4,5,359,127,391,141,32,14
cell_r4_c6.png,4,6,391,127,446,141,55,14
cell_r4_c7.png,4,7,446,127,502,141,56,14
cell_r4_c8.png,4,8,502,127,538,141,36,14
cell_r4_c9.png,4,9,538,126,570,141,32,15
cell_r4_c10.png,4,10,570,126,626,140,56,14
cell_r4_c11.png,4,11,626,127,698,141,72,14
cell_r4_c12.png,4,12,698,127,734,141,36,14
cell_r4_c13.png,4,13,734,127,766,141,32,14
cell_r4_c14.png,4,14,766,127,822,141,56,14
cell_r4_c15.png,4,15,822,127,887,141,65,14
cell_r4_c16.png,4,16,887,127,919,141,32,14
cell_r4_c17.png,4,17,919,127,985,141,66,14
cell_r4_c18.png,4,18,985,127,1050,141,65,14
cell_r4_c0.png,4,0,1,126,17,140,16,14
cell_r4_c1.png,4,1,17,126,229,140,212,14
cell_r4_c2.png,4,2,229,126,280,140,51,14
cell_r4_c3.png,4,3,280,126,324,140,44,14
cell_r4_c4.png,4,4,324,127,359,140,35,13
cell_r4_c5.png,4,5,359,127,391,141,32,14
cell_r4_c6.png,4,6,391,127,446,141,55,14
cell_r4_c7.png,4,7,446,127,502,141,56,14
cell_r4_c8.png,4,8,502,127,538,141,36,14
cell_r4_c9.png,4,9,538,126,570,141,32,15
cell_r4_c10.png,4,10,570,126,626,140,56,14
cell_r4_c11.png,4,11,626,127,698,141,72,14
cell_r4_c12.png,4,12,698,127,734,141,36,14
cell_r4_c13.png,4,13,734,127,766,141,32,14
cell_r4_c14.png,4,14,766,127,822,141,56,14
cell_r4_c15.png,4,15,822,127,887,141,65,14
cell_r4_c16.png,4,16,887,127,919,141,32,14
cell_r4_c17.png,4,17,919,127,985,141,66,14
cell_r4_c18.png,4,18,985,127,1050,141,65,14
cell_r4_c0.png,4,0,1,126,17,140,16,14
cell_r4_c1.png,4,1,17,126,229,140,212,14
cell_r4_c2.png,4,2,229,126,280,140,51,14
cell_r4_c3.png,4,3,280,126,324,140,44,14
cell_r4_c4.png,4,4,324,127,359,140,35,13
cell_r4_c5.png,4,5,359,127,391,141,32,14
cell_r4_c6.png,4,6,391,127,446,141,55,14
cell_r4_c7.png,4,7,446,127,502,141,56,14
cell_r4_c8.png,4,8,502,127,538,141,36,14
cell_r4_c9.png,4,9,538,126,570,141,32,15
cell_r4_c10.png,4,10,570,126,626,140,56,14
cell_r4_c11.png,4,11,626,127,698,141,72,14
cell_r4_c12.png,4,12,698,127,734,141,36,14
cell_r4_c13.png,4,13,734,127,766,141,32,14
cell_r4_c14.png,4,14,766,127,822,141,56,14
cell_r4_c15.png,4,15,822,127,887,141,65,14
cell_r4_c16.png,4,16,887,127,919,141,32,14
cell_r4_c17.png,4,17,919,127,985,141,66,14
cell_r4_c18.png,4,18,985,127,1050,141,65,14
cell_r4_c0.png,4,0,1,126,17,140,16,14
cell_r4_c1.png,4,1,17,126,229,140,212,14
cell_r4_c2.png,4,2,229,126,280,140,51,14
cell_r4_c3.png,4,3,280,126,324,140,44,14
cell_r4_c4.png,4,4,324,127,359,140,35,13
cell_r4_c5.png,4,5,359,127,391,141,32,14
cell_r4_c6.png,4,6,391,127,446,141,55,14
cell_r4_c7.png,4,7,446,127,502,141,56,14
cell_r4_c8.png,4,8,502,127,538,141,36,14
cell_r4_c9.png,4,9,538,126,570,141,32,15
cell_r4_c10.png,4,10,570,126,626,140,56,14
cell_r4_c11.png,4,11,626,127,698,141,72,14
cell_r4_c12.png,4,12,698,127,734,141,36,14
cell_r4_c13.png,4,13,734,127,766,141,32,14
cell_r4_c14.png,4,14,766,127,822,141,56,14
cell_r4_c15.png,4,15,822,127,887,141,65,14
cell_r4_c16.png,4,16,887,127,919,141,32,14
cell_r4_c17.png,4,17,919,127,985,141,66,14
cell_r4_c18.png,4,18,985,127,1050,141,65,14
cell_r4_c0.png,4,0,1,126,17,140,16,14
cell_r4_c1.png,4,1,17,126,229,140,212,14
cell_r4_c2.png,4,2,229,126,280,140,51,14
cell_r4_c3.png,4,3,280,126,324,140,44,14
cell_r4_c4.png,4,4,324,127,359,140,35,13
cell_r4_c5.png,4,5,359,127,391,141,32,14
cell_r4_c6.png,4,6,391,127,446,141,55,14
cell_r4_c7.png,4,7,446,127,502,141,56,14
cell_r4_c8.png,4,8,502,127,538,141,36,14
cell_r4_c9.png,4,9,538,126,570,141,32,15
cell_r4_c10.png,4,10,570,126,626,140,56,14
cell_r4_c11.png,4,11,626,127,698,141,72,14
cell_r4_c12.png,4,12,698,127,734,141,36,14
cell_r4_c13.png,4,13,734,127,766,141,32,14
cell_r4_c14.png,4,14,766,127,822,141,56,14
cell_r4_c15.png,4,15,822,127,887,141,65,14
cell_r4_c16.png,4,16,887,127,919,141,32,14
cell_r4_c17.png,4,17,919,127,985,141,66,14
cell_r4_c18.png,4,18,985,127,1050,141,65,14
cell_r4_c0.png,4,0,1,126,17,140,16,14
cell_r4_c1.png,4,1,17,126,229,140,212,14
cell_r4_c2.png,4,2,229,126,280,140,51,14
cell_r4_c3.png,4,3,280,126,324,140,44,14
cell_r4_c4.png,4,4,324,127,359,140,35,13
cell_r4_c5.png,4,5,359,127,391,141,32,14
cell_r4_c6.png,4,6,391,127,446,141,55,14
cell_r4_c7.png,4,7,446,127,502,141,56,14
cell_r4_c8.png,4,8,502,127,538,141,36,14
cell_r4_c9.png,4,9,538,126,570,141,32,15
cell_r4_c10.png,4,10,570,126,626,140,56,14
cell_r4_c11.png,4,11,626,127,698,141,72,14
cell_r4_c12.png,4,12,698,127,734,141,36,14
cell_r4_c13.png,4,13,734,127,766,141,32,14
cell_r4_c14.png,4,14,766,127,822,141,56,14
cell_r4_c15.png,4,15,822,127,887,141,65,14
cell_r4_c16.png,4,16,887,127,919,141,32,14
cell_r4_c17.png,4,17,919,127,985,141,66,14
cell_r4_c18.png,4,18,985,127,1050,141,65,14
cell_r4_c0.png,4,0,1,126,17,140,16,14
cell_r4_c1.png,4,1,17,126,229,140,212,14
cell_r4_c2.png,4,2,229,126,280,140,51,14
cell_r4_c3.png,4,3,280,126,324,140,44,14
cell_r4_c4.png,4,4,324,127,359,140,35,13
cell_r4_c5.png,4,5,359,127,391,141,32,14
cell_r4_c6.png,4,6,391,127,446,141,55,14
cell_r4_c7.png,4,7,446,127,502,141,56,14
cell_r4_c8.png,4,8,502,127,538,141,36,14
cell_r4_c9.png,4,9,538,126,570,141,32,15
cell_r4_c10.png,4,10,570,126,626,140,56,14
cell_r4_c11.png,4,11,626,127,698,141,72,14
cell_r4_c12.png,4,12,698,127,734,141,36,14
cell_r4_c13.png,4,13,734,127,766,141,32,14
cell_r4_c14.png,4,14,766,127,822,141,56,14
cell_r4_c15.png,4,15,822,127,887,141,65,14
cell_r4_c16.png,4,16,887,127,919,141,32,14
cell_r4_c17.png,4,17,919,127,985,141,66,14
cell_r4_c18.png,4,18,985,127,1050,141,65,14
cell_r4_c0.png,4,0,1,126,17,140,16,14
cell_r4_c1.png,4,1,17,126,229,140,212,14
cell_r4_c2.png,4,2,229,126,280,140,51,14
cell_r4_c3.png,4,3,280,126,324,140,44,14
cell_r4_c4.png,4,4,324,127,359,140,35,13
cell_r4_c5.png,4,5,359,127,391,141,32,14
cell_r4_c6.png,4,6,391,127,446,141,55,14
cell_r4_c7.png,4,7,446,127,502,141,56,14
cell_r4_c8.png,4,8,502,127,538,141,36,14
cell_r4_c9.png,4,9,538,126,570,141,32,15
cell_r4_c10.png,4,10,570,126,626,140,56,14
cell_r4_c11.png,4,11,626,127,698,141,72,14
cell_r4_c12.png,4,12,698,127,734,141,36,14
cell_r4_c13.png,4,13,734,127,766,141,32,14
cell_r4_c14.png,4,14,766,127,822,141,56,14
cell_r4_c15.png,4,15,822,127,887,141,65,14
cell_r4_c16.png,4,16,887,127,919,141,32,14
cell_r4_c17.png,4,17,919,127,985,141,66,14
cell_r4_c18.png,4,18,985,127,1050,141,65,14
cell_r4_c0.png,4,0,1,126,17,140,16,14
cell_r4_c1.png,4,1,17,126,229,140,212,14
cell_r4_c2.png,4,2,229,126,280,140,51,14
cell_r4_c3.png,4,3,280,126,324,140,44,14
cell_r4_c4.png,4,4,324,127,359,140,35,13
cell_r4_c5.png,4,5,359,127,391,141,32,14
cell_r4_c6.png,4,6,391,127,446,141,55,14
cell_r4_c7.png,4,7,446,127,502,141,56,14
cell_r4_c8.png,4,8,502,127,538,141,36,14
cell_r4_c9.png,4,9,538,126,570,141,32,15
cell_r4_c10.png,4,10,570,126,626,140,56,14
cell_r4_c11.png,4,11,626,127,698,141,72,14
cell_r4_c12.png,4,12,698,127,734,141,36,14
cell_r4_c13.png,4,13,734,127,766,141,32,14
cell_r4_c14.png,4,14,766,127,822,141,56,14
cell_r4_c15.png,4,15,822,127,887,141,65,14
cell_r4_c16.png,4,16,887,127,919,141,32,14
cell_r4_c17.png,4,17,919,127,985,141,66,14
cell_r4_c18.png,4,18,985,127,1050,141,65,14
cell_r4_c0.png,4,0,1,126,17,140,16,14
cell_r4_c1.png,4,1,17,126,229,140,212,14
cell_r4_c2.png,4,2,229,126,280,140,51,14
cell_r4_c3.png,4,3,280,126,324,140,44,14
cell_r4_c4.png,4,4,324,127,359,140,35,13
cell_r4_c5.png,4,5,359,127,391,141,32,14
cell_r4_c6.png,4,6,391,127,446,141,55,14
cell_r4_c7.png,4,7,446,127,502,141,56,14
cell_r4_c8.png,4,8,502,127,538,141,36,14
cell_r4_c9.png,4,9,538,126,570,141,32,15
cell_r4_c10.png,4,10,570,126,626,140,56,14
cell_r4_c11.png,4,11,626,127,698,141,72,14
cell_r4_c12.png,4,12,698,127,734,141,36,14
cell_r4_c13.png,4,13,734,127,766,141,32,14
cell_r4_c14.png,4,14,766,127,822,141,56,14
cell_r4_c15.png,4,15,822,127,887,141,65,14
cell_r4_c16.png,4,16,887,127,919,141,32,14
cell_r4_c17.png,4,17,919,127,985,141,66,14
cell_r4_c18.png,4,18,985,127,1050,141,65,14
cell_r4_c0.png,4,0,1,126,17,140,16,14
cell_r4_c1.png,4,1,17,126,229,140,212,14
cell_r4_c2.png,4,2,229,126,280,140,51,14
cell_r4_c3.png,4,3,280,126,324,140,44,14
cell_r4_c4.png,4,4,324,127,359,140,35,13
cell_r4_c5.png,4,5,359,127,391,141,32,14
cell_r4_c6.png,4,6,391,127,446,141,55,14
cell_r4_c7.png,4,7,446,127,502,141,56,14
cell_r4_c8.png,4,8,502,127,538,141,36,14
cell_r4_c9.png,4,9,538,126,570,141,32,15
cell_r4_c10.png,4,10,570,126,626,140,56,14
cell_r4_c11.png,4,11,626,127,698,141,72,14
cell_r4_c12.png,4,12,698,127,734,141,36,14
cell_r4_c13.png,4,13,734,127,766,141,32,14
cell_r4_c14.png,4,14,766,127,822,141,56,14
cell_r4_c15.png,4,15,822,127,887,141,65,14
cell_r4_c16.png,4,16,887,127,919,141,32,14
cell_r4_c17.png,4,17,919,127,985,141,66,14
cell_r4_c18.png,4,18,985,127,1050,141,65,14
cell_r4_c0.png,4,0,1,126,17,140,16,14
cell_r4_c1.png,4,1,17,126,229,140,212,14
cell_r4_c2.png,4,2,229,126,280,140,51,14
cell_r4_c3.png,4,3,280,126,324,140,44,14
cell_r4_c4.png,4,4,324,127,359,140,35,13
cell_r4_c5.png,4,5,359,127,391,141,32,14
cell_r4_c6.png,4,6,391,127,446,141,55,14
cell_r4_c7.png,4,7,446,127,502,141,56,14
cell_r4_c8.png,4,8,502,127,538,141,36,14
cell_r4_c9.png,4,9,538,126,570,141,32,15
cell_r4_c10.png,4,10,570,126,626,140,56,14
cell_r4_c11.png,4,11,626,127,698,141,72,14
cell_r4_c12.png,4,12,698,127,734,141,36,14
cell_r4_c13.png,4,13,734,127,766,141,32,14
cell_r4_c14.png,4,14,766,127,822,141,56,14
cell_r4_c15.png,4,15,822,127,887,141,65,14
cell_r4_c16.png,4,16,887,127,919,141,32,14
cell_r4_c17.png,4,17,919,127,985,141,66,14
cell_r4_c18.png,4,18,985,127,1050,141,65,14
cell_r4_c0.png,4,0,1,126,17,140,16,14
cell_r4_c1.png,4,1,17,126,229,140,212,14
cell_r4_c2.png,4,2,229,126,280,140,51,14
cell_r4_c3.png,4,3,280,126,324,140,44,14
cell_r4_c4.png,4,4,324,127,359,140,35,13
cell_r4_c5.png,4,5,359,127,391,141,32,14
cell_r4_c6.png,4,6,391,127,446,141,55,14
cell_r4_c7.png,4,7,446,127,502,141,56,14
cell_r4_c8.png,4,8,502,127,538,141,36,14
cell_r4_c9.png,4,9,538,126,570,141,32,15
cell_r4_c10.png,4,10,570,126,626,140,56,14
cell_r4_c11.png,4,11,626,127,698,141,72,14
cell_r4_c12.png,4,12,698,127,734,141,36,14
cell_r4_c13.png,4,13,734,127,766,141,32,14
cell_r4_c14.png,4,14,766,127,822,141,56,14
cell_r4_c15.png,4,15,822,127,887,141,65,14
cell_r4_c16.png,4,16,887,127,919,141,32,14
cell_r4_c17.png,4,17,919,127,985,141,66,14
cell_r4_c18.png,4,18,985,127,1050,141,65,14
cell_r4_c0.png,4,0,1,126,17,140,16,14
cell_r4_c1.png,4,1,17,126,229,140,212,14
cell_r4_c2.png,4,2,229,126,280,140,51,14
cell_r4_c3.png,4,3,280,126,324,140,44,14
cell_r4_c4.png,4,4,324,127,359,140,35,13
cell_r4_c5.png,4,5,359,127,391,141,32,14
cell_r4_c6.png,4,6,391,127,446,141,55,14
cell_r4_c7.png,4,7,446,127,502,141,56,14
cell_r4_c8.png,4,8,502,127,538,141,36,14
cell_r4_c9.png,4,9,538,126,570,141,32,15
cell_r4_c10.png,4,10,570,126,626,140,56,14
cell_r4_c11.png,4,11,626,127,698,141,72,14
cell_r4_c12.png,4,12,698,127,734,141,36,14
cell_r4_c13.png,4,13,734,127,766,141,32,14
cell_r4_c14.png,4,14,766,127,822,141,56,14
cell_r4_c15.png,4,15,822,127,887,141,65,14
cell_r4_c16.png,4,16,887,127,919,141,32,14
cell_r4_c17.png,4,17,919,127,985,141,66,14
cell_r4_c18.png,4,18,985,127,1050,141,65,14
cell_r4_c0.png,4,0,1,126,17,140,16,14
cell_r4_c1.png,4,1,17,126,229,140,212,14
cell_r4_c2.png,4,2,229,126,280,140,51,14
cell_r4_c3.png,4,3,280,126,324,140,44,14
cell_r4_c4.png,4,4,324,127,359,140,35,13
cell_r4_c5.png,4,5,359,127,391,141,32,14
cell_r4_c6.png,4,6,391,127,446,141,55,14
cell_r4_c7.png,4,7,446,127,502,141,56,14
cell_r4_c8.png,4,8,502,127,538,141,36,14
cell_r4_c9.png,4,9,538,126,570,141,32,15
cell_r4_c10.png,4,10,570,126,626,140,56,14
cell_r4_c11.png,4,11,626,127,698,141,72,14
cell_r4_c12.png,4,12,698,127,734,141,36,14
cell_r4_c13.png,4,13,734,127,766,141,32,14
cell_r4_c14.png,4,14,766,127,822,141,56,14
cell_r4_c15.png,4,15,822,127,887,141,65,14
cell_r4_c16.png,4,16,887,127,919,141,32,14
cell_r4_c17.png,4,17,919,127,985,141,66,14
cell_r4_c18.png,4,18,985,127,1050,141,65,14
cell_r4_c0.png,4,0,1,126,17,140,16,14
cell_r4_c1.png,4,1,17,126,229,140,212,14
cell_r4_c2.png,4,2,229,126,280,140,51,14
cell_r4_c3.png,4,3,280,126,324,140,44,14
cell_r4_c4.png,4,4,324,127,359,140,35,13
cell_r4_c5.png,4,5,359,127,391,141,32,14
cell_r4_c6.png,4,6,391,127,446,141,55,14
cell_r4_c7.png,4,7,446,127,502,141,56,14
cell_r4_c8.png,4,8,502,127,538,141,36,14
cell_r4_c9.png,4,9,538,126,570,141,32,15
cell_r4_c10.png,4,10,570,126,626,140,56,14
cell_r4_c11.png,4,11,626,127,698,141,72,14
cell_r4_c12.png,4,12,698,127,734,141,36,14
cell_r4_c13.png,4,13,734,127,766,141,32,14
cell_r4_c14.png,4,14,766,127,822,141,56,14
cell_r4_c15.png,4,15,822,127,887,141,65,14
cell_r4_c16.png,4,16,887,127,919,141,32,14
cell_r4_c17.png,4,17,919,127,985,141,66,14
cell_r4_c18.png,4,18,985,127,1050,141,65,14
cell_r4_c0.png,4,0,1,126,17,140,16,14
cell_r4_c1.png,4,1,17,126,229,140,212,14
cell_r4_c2.png,4,2,229,126,280,140,51,14
cell_r4_c3.png,4,3,280,126,324,140,44,14
cell_r4_c4.png,4,4,324,127,359,140,35,13
cell_r4_c5.png,4,5,359,127,391,141,32,14
cell_r4_c6.png,4,6,391,127,446,141,55,14
cell_r4_c7.png,4,7,446,127,502,141,56,14
cell_r4_c8.png,4,8,502,127,538,141,36,14
cell_r4_c9.png,4,9,538,126,570,141,32,15
cell_r4_c10.png,4,10,570,126,626,140,56,14
cell_r4_c11.png,4,11,626,127,698,141,72,14
cell_r4_c12.png,4,12,698,127,734,141,36,14
cell_r4_c13.png,4,13,734,127,766,141,32,14
cell_r4_c14.png,4,14,766,127,822,141,56,14
cell_r4_c15.png,4,15,822,127,887,141,65,14
cell_r4_c16.png,4,16,887,127,919,141,32,14
cell_r4_c17.png,4,17,919,127,985,141,66,14
cell_r4_c18.png,4,18,985,127,1050,141,65,14
cell_r4_c0.png,4,0,1,126,17,140,16,14
cell_r4_c1.png,4,1,17,126,229,140,212,14
cell_r4_c2.png,4,2,229,126,280,140,51,14
cell_r4_c3.png,4,3,280,126,324,140,44,14
cell_r4_c4.png,4,4,324,127,359,140,35,13
cell_r4_c5.png,4,5,359,127,391,141,32,14
cell_r4_c6.png,4,6,391,127,446,141,55,14
cell_r4_c7.png,4,7,446,127,502,141,56,14
cell_r4_c8.png,4,8,502,127,538,141,36,14
cell_r4_c9.png,4,9,538,126,570,141,32,15
cell_r4_c10.png,4,10,570,126,626,140,56,14
cell_r4_c11.png,4,11,626,127,698,141,72,14
cell_r4_c12.png,4,12,698,127,734,141,36,14
cell_r4_c13.png,4,13,734,127,766,141,32,14
cell_r4_c14.png,4,14,766,127,822,141,56,14
cell_r4_c15.png,4,15,822,127,887,141,65,14
cell_r4_c16.png,4,16,887,127,919,141,32,14
cell_r4_c17.png,4,17,919,127,985,141,66,14
cell_r4_c18.png,4,18,985,127,1050,141,65,14
cell_r5_c0.png,5,0,1,140,17,158,16,18
cell_r5_c1.png,5,1,16,140,229,159,213,19
cell_r5_c2.png,5,2,229,140,280,159,51,19
cell_r5_c3.png,5,3,280,140,324,159,44,19
cell_r5_c4.png,5,4,324,140,359,159,35,19
cell_r5_c5.png,5,5,359,140,391,159,32,19
cell_r5_c6.png,5,6,391,140,446,159,55,19
cell_r5_c7.png,5,7,446,140,502,159,56,19
cell_r5_c8.png,5,8,502,141,538,160,36,19
cell_r5_c9.png,5,9,538,140,570,160,32,20
cell_r5_c10.png,5,10,570,140,626,160,56,20
cell_r5_c11.png,5,11,626,140,698,160,72,20
cell_r5_c12.png,5,12,698,141,734,160,36,19
cell_r5_c13.png,5,13,734,141,766,160,32,19
cell_r5_c14.png,5,14,766,141,822,160,56,19
cell_r5_c15.png,5,15,822,141,887,160,65,19
cell_r5_c16.png,5,16,887,141,919,160,32,19
cell_r5_c17.png,5,17,919,141,985,160,66,19
cell_r5_c18.png,5,18,985,141,1050,160,65,19
cell_r5_c0.png,5,0,1,140,17,158,16,18
cell_r5_c1.png,5,1,16,140,229,159,213,19
cell_r5_c2.png,5,2,229,140,280,159,51,19
cell_r5_c3.png,5,3,280,140,324,159,44,19
cell_r5_c4.png,5,4,324,140,359,159,35,19
cell_r5_c5.png,5,5,359,140,391,159,32,19
cell_r5_c6.png,5,6,391,140,446,159,55,19
cell_r5_c7.png,5,7,446,140,502,159,56,19
cell_r5_c8.png,5,8,502,141,538,160,36,19
cell_r5_c9.png,5,9,538,140,570,160,32,20
cell_r5_c10.png,5,10,570,140,626,160,56,20
cell_r5_c11.png,5,11,626,140,698,160,72,20
cell_r5_c12.png,5,12,698,141,734,160,36,19
cell_r5_c13.png,5,13,734,141,766,160,32,19
cell_r5_c14.png,5,14,766,141,822,160,56,19
cell_r5_c15.png,5,15,822,141,887,160,65,19
cell_r5_c16.png,5,16,887,141,919,160,32,19
cell_r5_c17.png,5,17,919,141,985,160,66,19
cell_r5_c18.png,5,18,985,141,1050,160,65,19
cell_r5_c0.png,5,0,1,140,17,158,16,18
cell_r5_c1.png,5,1,16,140,229,159,213,19
cell_r5_c2.png,5,2,229,140,280,159,51,19
cell_r5_c3.png,5,3,280,140,324,159,44,19
cell_r5_c4.png,5,4,324,140,359,159,35,19
cell_r5_c5.png,5,5,359,140,391,159,32,19
cell_r5_c6.png,5,6,391,140,446,159,55,19
cell_r5_c7.png,5,7,446,140,502,159,56,19
cell_r5_c8.png,5,8,502,141,538,160,36,19
cell_r5_c9.png,5,9,538,140,570,160,32,20
cell_r5_c10.png,5,10,570,140,626,160,56,20
cell_r5_c11.png,5,11,626,140,698,160,72,20
cell_r5_c12.png,5,12,698,141,734,160,36,19
cell_r5_c13.png,5,13,734,141,766,160,32,19
cell_r5_c14.png,5,14,766,141,822,160,56,19
cell_r5_c15.png,5,15,822,141,887,160,65,19
cell_r5_c16.png,5,16,887,141,919,160,32,19
cell_r5_c17.png,5,17,919,141,985,160,66,19
cell_r5_c18.png,5,18,985,141,1050,160,65,19
cell_r5_c0.png,5,0,1,140,17,158,16,18
cell_r5_c1.png,5,1,16,140,229,159,213,19
cell_r5_c2.png,5,2,229,140,280,159,51,19
cell_r5_c3.png,5,3,280,140,324,159,44,19
cell_r5_c4.png,5,4,324,140,359,159,35,19
cell_r5_c5.png,5,5,359,140,391,159,32,19
cell_r5_c6.png,5,6,391,140,446,159,55,19
cell_r5_c7.png,5,7,446,140,502,159,56,19
cell_r5_c8.png,5,8,502,141,538,160,36,19
cell_r5_c9.png,5,9,538,140,570,160,32,20
cell_r5_c10.png,5,10,570,140,626,160,56,20
cell_r5_c11.png,5,11,626,140,698,160,72,20
cell_r5_c12.png,5,12,698,141,734,160,36,19
cell_r5_c13.png,5,13,734,141,766,160,32,19
cell_r5_c14.png,5,14,766,141,822,160,56,19
cell_r5_c15.png,5,15,822,141,887,160,65,19
cell_r5_c16.png,5,16,887,141,919,160,32,19
cell_r5_c17.png,5,17,919,141,985,160,66,19
cell_r5_c18.png,5,18,985,141,1050,160,65,19
cell_r5_c0.png,5,0,1,140,17,158,16,18
cell_r5_c1.png,5,1,16,140,229,159,213,19
cell_r5_c2.png,5,2,229,140,280,159,51,19
cell_r5_c3.png,5,3,280,140,324,159,44,19
cell_r5_c4.png,5,4,324,140,359,159,35,19
cell_r5_c5.png,5,5,359,140,391,159,32,19
cell_r5_c6.png,5,6,391,140,446,159,55,19
cell_r5_c7.png,5,7,446,140,502,159,56,19
cell_r5_c8.png,5,8,502,141,538,160,36,19
cell_r5_c9.png,5,9,538,140,570,160,32,20
cell_r5_c10.png,5,10,570,140,626,160,56,20
cell_r5_c11.png,5,11,626,140,698,160,72,20
cell_r5_c12.png,5,12,698,141,734,160,36,19
cell_r5_c13.png,5,13,734,141,766,160,32,19
cell_r5_c14.png,5,14,766,141,822,160,56,19
cell_r5_c15.png,5,15,822,141,887,160,65,19
cell_r5_c16.png,5,16,887,141,919,160,32,19
cell_r5_c17.png,5,17,919,141,985,160,66,19
cell_r5_c18.png,5,18,985,141,1050,160,65,19
cell_r5_c0.png,5,0,1,140,17,158,16,18
cell_r5_c1.png,5,1,16,140,229,159,213,19
cell_r5_c2.png,5,2,229,140,280,159,51,19
cell_r5_c3.png,5,3,280,140,324,159,44,19
cell_r5_c4.png,5,4,324,140,359,159,35,19
cell_r5_c5.png,5,5,359,140,391,159,32,19
cell_r5_c6.png,5,6,391,140,446,159,55,19
cell_r5_c7.png,5,7,446,140,502,159,56,19
cell_r5_c8.png,5,8,502,141,538,160,36,19
cell_r5_c9.png,5,9,538,140,570,160,32,20
cell_r5_c10.png,5,10,570,140,626,160,56,20
cell_r5_c11.png,5,11,626,140,698,160,72,20
cell_r5_c12.png,5,12,698,141,734,160,36,19
cell_r5_c13.png,5,13,734,141,766,160,32,19
cell_r5_c14.png,5,14,766,141,822,160,56,19
cell_r5_c15.png,5,15,822,141,887,160,65,19
cell_r5_c16.png,5,16,887,141,919,160,32,19
cell_r5_c17.png,5,17,919,141,985,160,66,19
cell_r5_c18.png,5,18,985,141,1050,160,65,19
cell_r5_c0.png,5,0,1,140,17,158,16,18
cell_r5_c1.png,5,1,16,140,229,159,213,19
cell_r5_c2.png,5,2,229,140,280,159,51,19
cell_r5_c3.png,5,3,280,140,324,159,44,19
cell_r5_c4.png,5,4,324,140,359,159,35,19
cell_r5_c5.png,5,5,359,140,391,159,32,19
cell_r5_c6.png,5,6,391,140,446,159,55,19
cell_r5_c7.png,5,7,446,140,502,159,56,19
cell_r5_c8.png,5,8,502,141,538,160,36,19
cell_r5_c9.png,5,9,538,140,570,160,32,20
cell_r5_c10.png,5,10,570,140,626,160,56,20
cell_r5_c11.png,5,11,626,140,698,160,72,20
cell_r5_c12.png,5,12,698,141,734,160,36,19
cell_r5_c13.png,5,13,734,141,766,160,32,19
cell_r5_c14.png,5,14,766,141,822,160,56,19
cell_r5_c15.png,5,15,822,141,887,160,65,19
cell_r5_c16.png,5,16,887,141,919,160,32,19
cell_r5_c17.png,5,17,919,141,985,160,66,19
cell_r5_c18.png,5,18,985,141,1050,160,65,19
cell_r5_c0.png,5,0,1,140,17,158,16,18
cell_r5_c1.png,5,1,16,140,229,159,213,19
cell_r5_c2.png,5,2,229,140,280,159,51,19
cell_r5_c3.png,5,3,280,140,324,159,44,19
cell_r5_c4.png,5,4,324,140,359,159,35,19
cell_r5_c5.png,5,5,359,140,391,159,32,19
cell_r5_c6.png,5,6,391,140,446,159,55,19
cell_r5_c7.png,5,7,446,140,502,159,56,19
cell_r5_c8.png,5,8,502,141,538,160,36,19
cell_r5_c9.png,5,9,538,140,570,160,32,20
cell_r5_c10.png,5,10,570,140,626,160,56,20
cell_r5_c11.png,5,11,626,140,698,160,72,20
cell_r5_c12.png,5,12,698,141,734,160,36,19
cell_r5_c13.png,5,13,734,141,766,160,32,19
cell_r5_c14.png,5,14,766,141,822,160,56,19
cell_r5_c15.png,5,15,822,141,887,160,65,19
cell_r5_c16.png,5,16,887,141,919,160,32,19
cell_r5_c17.png,5,17,919,141,985,160,66,19
cell_r5_c18.png,5,18,985,141,1050,160,65,19
cell_r5_c0.png,5,0,1,140,17,158,16,18
cell_r5_c1.png,5,1,16,140,229,159,213,19
cell_r5_c2.png,5,2,229,140,280,159,51,19
cell_r5_c3.png,5,3,280,140,324,159,44,19
cell_r5_c4.png,5,4,324,140,359,159,35,19
cell_r5_c5.png,5,5,359,140,391,159,32,19
cell_r5_c6.png,5,6,391,140,446,159,55,19
cell_r5_c7.png,5,7,446,140,502,159,56,19
cell_r5_c8.png,5,8,502,141,538,160,36,19
cell_r5_c9.png,5,9,538,140,570,160,32,20
cell_r5_c10.png,5,10,570,140,626,160,56,20
cell_r5_c11.png,5,11,626,140,698,160,72,20
cell_r5_c12.png,5,12,698,141,734,160,36,19
cell_r5_c13.png,5,13,734,141,766,160,32,19
cell_r5_c14.png,5,14,766,141,822,160,56,19
cell_r5_c15.png,5,15,822,141,887,160,65,19
cell_r5_c16.png,5,16,887,141,919,160,32,19
cell_r5_c17.png,5,17,919,141,985,160,66,19
cell_r5_c18.png,5,18,985,141,1050,160,65,19
cell_r5_c0.png,5,0,1,140,17,158,16,18
cell_r5_c1.png,5,1,16,140,229,159,213,19
cell_r5_c2.png,5,2,229,140,280,159,51,19
cell_r5_c3.png,5,3,280,140,324,159,44,19
cell_r5_c4.png,5,4,324,140,359,159,35,19
cell_r5_c5.png,5,5,359,140,391,159,32,19
cell_r5_c6.png,5,6,391,140,446,159,55,19
cell_r5_c7.png,5,7,446,140,502,159,56,19
cell_r5_c8.png,5,8,502,141,538,160,36,19
cell_r5_c9.png,5,9,538,140,570,160,32,20
cell_r5_c10.png,5,10,570,140,626,160,56,20
cell_r5_c11.png,5,11,626,140,698,160,72,20
cell_r5_c12.png,5,12,698,141,734,160,36,19
cell_r5_c13.png,5,13,734,141,766,160,32,19
cell_r5_c14.png,5,14,766,141,822,160,56,19
cell_r5_c15.png,5,15,822,141,887,160,65,19
cell_r5_c16.png,5,16,887,141,919,160,32,19
cell_r5_c17.png,5,17,919,141,985,160,66,19
cell_r5_c18.png,5,18,985,141,1050,160,65,19
cell_r5_c0.png,5,0,1,140,17,158,16,18
cell_r5_c1.png,5,1,16,140,229,159,213,19
cell_r5_c2.png,5,2,229,140,280,159,51,19
cell_r5_c3.png,5,3,280,140,324,159,44,19
cell_r5_c4.png,5,4,324,140,359,159,35,19
cell_r5_c5.png,5,5,359,140,391,159,32,19
cell_r5_c6.png,5,6,391,140,446,159,55,19
cell_r5_c7.png,5,7,446,140,502,159,56,19
cell_r5_c8.png,5,8,502,141,538,160,36,19
cell_r5_c9.png,5,9,538,140,570,160,32,20
cell_r5_c10.png,5,10,570,140,626,160,56,20
cell_r5_c11.png,5,11,626,140,698,160,72,20
cell_r5_c12.png,5,12,698,141,734,160,36,19
cell_r5_c13.png,5,13,734,141,766,160,32,19
cell_r5_c14.png,5,14,766,141,822,160,56,19
cell_r5_c15.png,5,15,822,141,887,160,65,19
cell_r5_c16.png,5,16,887,141,919,160,32,19
cell_r5_c17.png,5,17,919,141,985,160,66,19
cell_r5_c18.png,5,18,985,141,1050,160,65,19
cell_r5_c0.png,5,0,1,140,17,158,16,18
cell_r5_c1.png,5,1,16,140,229,159,213,19
cell_r5_c2.png,5,2,229,140,280,159,51,19
cell_r5_c3.png,5,3,280,140,324,159,44,19
cell_r5_c4.png,5,4,324,140,359,159,35,19
cell_r5_c5.png,5,5,359,140,391,159,32,19
cell_r5_c6.png,5,6,391,140,446,159,55,19
cell_r5_c7.png,5,7,446,140,502,159,56,19
cell_r5_c8.png,5,8,502,141,538,160,36,19
cell_r5_c9.png,5,9,538,140,570,160,32,20
cell_r5_c10.png,5,10,570,140,626,160,56,20
cell_r5_c11.png,5,11,626,140,698,160,72,20
cell_r5_c12.png,5,12,698,141,734,160,36,19
cell_r5_c13.png,5,13,734,141,766,160,32,19
cell_r5_c14.png,5,14,766,141,822,160,56,19
cell_r5_c15.png,5,15,822,141,887,160,65,19
cell_r5_c16.png,5,16,887,141,919,160,32,19
cell_r5_c17.png,5,17,919,141,985,160,66,19
cell_r5_c18.png,5,18,985,141,1050,160,65,19
cell_r5_c0.png,5,0,1,140,17,158,16,18
cell_r5_c1.png,5,1,16,140,229,159,213,19
cell_r5_c2.png,5,2,229,140,280,159,51,19
cell_r5_c3.png,5,3,280,140,324,159,44,19
cell_r5_c4.png,5,4,324,140,359,159,35,19
cell_r5_c5.png,5,5,359,140,391,159,32,19
cell_r5_c6.png,5,6,391,140,446,159,55,19
cell_r5_c7.png,5,7,446,140,502,159,56,19
cell_r5_c8.png,5,8,502,141,538,160,36,19
cell_r5_c9.png,5,9,538,140,570,160,32,20
cell_r5_c10.png,5,10,570,140,626,160,56,20
cell_r5_c11.png,5,11,626,140,698,160,72,20
cell_r5_c12.png,5,12,698,141,734,160,36,19
cell_r5_c13.png,5,13,734,141,766,160,32,19
cell_r5_c14.png,5,14,766,141,822,160,56,19
cell_r5_c15.png,5,15,822,141,887,160,65,19
cell_r5_c16.png,5,16,887,141,919,160,32,19
cell_r5_c17.png,5,17,919,141,985,160,66,19
cell_r5_c18.png,5,18,985,141,1050,160,65,19
cell_r5_c0.png,5,0,1,140,17,158,16,18
cell_r5_c1.png,5,1,16,140,229,159,213,19
cell_r5_c2.png,5,2,229,140,280,159,51,19
cell_r5_c3.png,5,3,280,140,324,159,44,19
cell_r5_c4.png,5,4,324,140,359,159,35,19
cell_r5_c5.png,5,5,359,140,391,159,32,19
cell_r5_c6.png,5,6,391,140,446,159,55,19
cell_r5_c7.png,5,7,446,140,502,159,56,19
cell_r5_c8.png,5,8,502,141,538,160,36,19
cell_r5_c9.png,5,9,538,140,570,160,32,20
cell_r5_c10.png,5,10,570,140,626,160,56,20
cell_r5_c11.png,5,11,626,140,698,160,72,20
cell_r5_c12.png,5,12,698,141,734,160,36,19
cell_r5_c13.png,5,13,734,141,766,160,32,19
cell_r5_c14.png,5,14,766,141,822,160,56,19
cell_r5_c15.png,5,15,822,141,887,160,65,19
cell_r5_c16.png,5,16,887,141,919,160,32,19
cell_r5_c17.png,5,17,919,141,985,160,66,19
cell_r5_c18.png,5,18,985,141,1050,160,65,19
cell_r5_c0.png,5,0,1,140,17,158,16,18
cell_r5_c1.png,5,1,16,140,229,159,213,19
cell_r5_c2.png,5,2,229,140,280,159,51,19
cell_r5_c3.png,5,3,280,140,324,159,44,19
cell_r5_c4.png,5,4,324,140,359,159,35,19
cell_r5_c5.png,5,5,359,140,391,159,32,19
cell_r5_c6.png,5,6,391,140,446,159,55,19
cell_r5_c7.png,5,7,446,140,502,159,56,19
cell_r5_c8.png,5,8,502,141,538,160,36,19
cell_r5_c9.png,5,9,538,140,570,160,32,20
cell_r5_c10.png,5,10,570,140,626,160,56,20
cell_r5_c11.png,5,11,626,140,698,160,72,20
cell_r5_c12.png,5,12,698,141,734,160,36,19
cell_r5_c13.png,5,13,734,141,766,160,32,19
cell_r5_c14.png,5,14,766,141,822,160,56,19
cell_r5_c15.png,5,15,822,141,887,160,65,19
cell_r5_c16.png,5,16,887,141,919,160,32,19
cell_r5_c17.png,5,17,919,141,985,160,66,19
cell_r5_c18.png,5,18,985,141,1050,160,65,19
cell_r5_c0.png,5,0,1,140,17,158,16,18
cell_r5_c1.png,5,1,16,140,229,159,213,19
cell_r5_c2.png,5,2,229,140,280,159,51,19
cell_r5_c3.png,5,3,280,140,324,159,44,19
cell_r5_c4.png,5,4,324,140,359,159,35,19
cell_r5_c5.png,5,5,359,140,391,159,32,19
cell_r5_c6.png,5,6,391,140,446,159,55,19
cell_r5_c7.png,5,7,446,140,502,159,56,19
cell_r5_c8.png,5,8,502,141,538,160,36,19
cell_r5_c9.png,5,9,538,140,570,160,32,20
cell_r5_c10.png,5,10,570,140,626,160,56,20
cell_r5_c11.png,5,11,626,140,698,160,72,20
cell_r5_c12.png,5,12,698,141,734,160,36,19
cell_r5_c13.png,5,13,734,141,766,160,32,19
cell_r5_c14.png,5,14,766,141,822,160,56,19
cell_r5_c15.png,5,15,822,141,887,160,65,19
cell_r5_c16.png,5,16,887,141,919,160,32,19
cell_r5_c17.png,5,17,919,141,985,160,66,19
cell_r5_c18.png,5,18,985,141,1050,160,65,19
cell_r5_c0.png,5,0,1,140,17,158,16,18
cell_r5_c1.png,5,1,16,140,229,159,213,19
cell_r5_c2.png,5,2,229,140,280,159,51,19
cell_r5_c3.png,5,3,280,140,324,159,44,19
cell_r5_c4.png,5,4,324,140,359,159,35,19
cell_r5_c5.png,5,5,359,140,391,159,32,19
cell_r5_c6.png,5,6,391,140,446,159,55,19
cell_r5_c7.png,5,7,446,140,502,159,56,19
cell_r5_c8.png,5,8,502,141,538,160,36,19
cell_r5_c9.png,5,9,538,140,570,160,32,20
cell_r5_c10.png,5,10,570,140,626,160,56,20
cell_r5_c11.png,5,11,626,140,698,160,72,20
cell_r5_c12.png,5,12,698,141,734,160,36,19
cell_r5_c13.png,5,13,734,141,766,160,32,19
cell_r5_c14.png,5,14,766,141,822,160,56,19
cell_r5_c15.png,5,15,822,141,887,160,65,19
cell_r5_c16.png,5,16,887,141,919,160,32,19
cell_r5_c17.png,5,17,919,141,985,160,66,19
cell_r5_c18.png,5,18,985,141,1050,160,65,19
cell_r5_c0.png,5,0,1,140,17,158,16,18
cell_r5_c1.png,5,1,16,140,229,159,213,19
cell_r5_c2.png,5,2,229,140,280,159,51,19
cell_r5_c3.png,5,3,280,140,324,159,44,19
cell_r5_c4.png,5,4,324,140,359,159,35,19
cell_r5_c5.png,5,5,359,140,391,159,32,19
cell_r5_c6.png,5,6,391,140,446,159,55,19
cell_r5_c7.png,5,7,446,140,502,159,56,19
cell_r5_c8.png,5,8,502,141,538,160,36,19
cell_r5_c9.png,5,9,538,140,570,160,32,20
cell_r5_c10.png,5,10,570,140,626,160,56,20
cell_r5_c11.png,5,11,626,140,698,160,72,20
cell_r5_c12.png,5,12,698,141,734,160,36,19
cell_r5_c13.png,5,13,734,141,766,160,32,19
cell_r5_c14.png,5,14,766,141,822,160,56,19
cell_r5_c15.png,5,15,822,141,887,160,65,19
cell_r5_c16.png,5,16,887,141,919,160,32,19
cell_r5_c17.png,5,17,919,141,985,160,66,19
cell_r5_c18.png,5,18,985,141,1050,160,65,19
cell_r5_c0.png,5,0,1,140,17,158,16,18
cell_r5_c1.png,5,1,16,140,229,159,213,19
cell_r5_c2.png,5,2,229,140,280,159,51,19
cell_r5_c3.png,5,3,280,140,324,159,44,19
cell_r5_c4.png,5,4,324,140,359,159,35,19
cell_r5_c5.png,5,5,359,140,391,159,32,19
cell_r5_c6.png,5,6,391,140,446,159,55,19
cell_r5_c7.png,5,7,446,140,502,159,56,19
cell_r5_c8.png,5,8,502,141,538,160,36,19
cell_r5_c9.png,5,9,538,140,570,160,32,20
cell_r5_c10.png,5,10,570,140,626,160,56,20
cell_r5_c11.png,5,11,626,140,698,160,72,20
cell_r5_c12.png,5,12,698,141,734,160,36,19
cell_r5_c13.png,5,13,734,141,766,160,32,19
cell_r5_c14.png,5,14,766,141,822,160,56,19
cell_r5_c15.png,5,15,822,141,887,160,65,19
cell_r5_c16.png,5,16,887,141,919,160,32,19
cell_r5_c17.png,5,17,919,141,985,160,66,19
cell_r5_c18.png,5,18,985,141,1050,160,65,19
cell_r6_c0.png,6,0,1,158,16,170,15,12
cell_r6_c1.png,6,1,16,158,229,170,213,12
cell_r6_c2.png,6,2,229,159,280,170,51,11
cell_r6_c3.png,6,3,280,159,324,170,44,11
cell_r6_c4.png,6,4,323,159,359,170,36,11
cell_r6_c5.png,6,5,359,159,391,171,32,12
cell_r6_c6.png,6,6,391,159,446,171,55,12
cell_r6_c7.png,6,7,446,159,502,170,56,11
cell_r6_c8.png,6,8,502,159,538,171,36,12
cell_r6_c9.png,6,9,538,160,570,171,32,11
cell_r6_c10.png,6,10,570,159,626,171,56,12
cell_r6_c11.png,6,11,626,159,698,171,72,12
cell_r6_c12.png,6,12,698,160,734,171,36,11
cell_r6_c13.png,6,13,734,159,766,171,32,12
cell_r6_c14.png,6,14,766,159,822,171,56,12
cell_r6_c15.png,6,15,822,160,887,171,65,11
cell_r6_c16.png,6,16,887,160,919,171,32,11
cell_r6_c17.png,6,17,919,160,985,171,66,11
cell_r6_c18.png,6,18,985,160,1050,171,65,11
cell_r6_c0.png,6,0,1,158,16,170,15,12
cell_r6_c1.png,6,1,16,158,229,170,213,12
cell_r6_c2.png,6,2,229,159,280,170,51,11
cell_r6_c3.png,6,3,280,159,324,170,44,11
cell_r6_c4.png,6,4,323,159,359,170,36,11
cell_r6_c5.png,6,5,359,159,391,171,32,12
cell_r6_c6.png,6,6,391,159,446,171,55,12
cell_r6_c7.png,6,7,446,159,502,170,56,11
cell_r6_c8.png,6,8,502,159,538,171,36,12
cell_r6_c9.png,6,9,538,160,570,171,32,11
cell_r6_c10.png,6,10,570,159,626,171,56,12
cell_r6_c11.png,6,11,626,159,698,171,72,12
cell_r6_c12.png,6,12,698,160,734,171,36,11
cell_r6_c13.png,6,13,734,159,766,171,32,12
cell_r6_c14.png,6,14,766,159,822,171,56,12
cell_r6_c15.png,6,15,822,160,887,171,65,11
cell_r6_c16.png,6,16,887,160,919,171,32,11
cell_r6_c17.png,6,17,919,160,985,171,66,11
cell_r6_c18.png,6,18,985,160,1050,171,65,11
cell_r6_c0.png,6,0,1,158,16,170,15,12
cell_r6_c1.png,6,1,16,158,229,170,213,12
cell_r6_c2.png,6,2,229,159,280,170,51,11
cell_r6_c3.png,6,3,280,159,324,170,44,11
cell_r6_c4.png,6,4,323,159,359,170,36,11
cell_r6_c5.png,6,5,359,159,391,171,32,12
cell_r6_c6.png,6,6,391,159,446,171,55,12
cell_r6_c7.png,6,7,446,159,502,170,56,11
cell_r6_c8.png,6,8,502,159,538,171,36,12
cell_r6_c9.png,6,9,538,160,570,171,32,11
cell_r6_c10.png,6,10,570,159,626,171,56,12
cell_r6_c11.png,6,11,626,159,698,171,72,12
cell_r6_c12.png,6,12,698,160,734,171,36,11
cell_r6_c13.png,6,13,734,159,766,171,32,12
cell_r6_c14.png,6,14,766,159,822,171,56,12
cell_r6_c15.png,6,15,822,160,887,171,65,11
cell_r6_c16.png,6,16,887,160,919,171,32,11
cell_r6_c17.png,6,17,919,160,985,171,66,11
cell_r6_c18.png,6,18,985,160,1050,171,65,11
cell_r6_c0.png,6,0,1,158,16,170,15,12
cell_r6_c1.png,6,1,16,158,229,170,213,12
cell_r6_c2.png,6,2,229,159,280,170,51,11
cell_r6_c3.png,6,3,280,159,324,170,44,11
cell_r6_c4.png,6,4,323,159,359,170,36,11
cell_r6_c5.png,6,5,359,159,391,171,32,12
cell_r6_c6.png,6,6,391,159,446,171,55,12
cell_r6_c7.png,6,7,446,159,502,170,56,11
cell_r6_c8.png,6,8,502,159,538,171,36,12
cell_r6_c9.png,6,9,538,160,570,171,32,11
cell_r6_c10.png,6,10,570,159,626,171,56,12
cell_r6_c11.png,6,11,626,159,698,171,72,12
cell_r6_c12.png,6,12,698,160,734,171,36,11
cell_r6_c13.png,6,13,734,159,766,171,32,12
cell_r6_c14.png,6,14,766,159,822,171,56,12
cell_r6_c15.png,6,15,822,160,887,171,65,11
cell_r6_c16.png,6,16,887,160,919,171,32,11
cell_r6_c17.png,6,17,919,160,985,171,66,11
cell_r6_c18.png,6,18,985,160,1050,171,65,11
cell_r6_c0.png,6,0,1,158,16,170,15,12
cell_r6_c1.png,6,1,16,158,229,170,213,12
cell_r6_c2.png,6,2,229,159,280,170,51,11
cell_r6_c3.png,6,3,280,159,324,170,44,11
cell_r6_c4.png,6,4,323,159,359,170,36,11
cell_r6_c5.png,6,5,359,159,391,171,32,12
cell_r6_c6.png,6,6,391,159,446,171,55,12
cell_r6_c7.png,6,7,446,159,502,170,56,11
cell_r6_c8.png,6,8,502,159,538,171,36,12
cell_r6_c9.png,6,9,538,160,570,171,32,11
cell_r6_c10.png,6,10,570,159,626,171,56,12
cell_r6_c11.png,6,11,626,159,698,171,72,12
cell_r6_c12.png,6,12,698,160,734,171,36,11
cell_r6_c13.png,6,13,734,159,766,171,32,12
cell_r6_c14.png,6,14,766,159,822,171,56,12
cell_r6_c15.png,6,15,822,160,887,171,65,11
cell_r6_c16.png,6,16,887,160,919,171,32,11
cell_r6_c17.png,6,17,919,160,985,171,66,11
cell_r6_c18.png,6,18,985,160,1050,171,65,11
cell_r6_c0.png,6,0,1,158,16,170,15,12
cell_r6_c1.png,6,1,16,158,229,170,213,12
cell_r6_c2.png,6,2,229,159,280,170,51,11
cell_r6_c3.png,6,3,280,159,324,170,44,11
cell_r6_c4.png,6,4,323,159,359,170,36,11
cell_r6_c5.png,6,5,359,159,391,171,32,12
cell_r6_c6.png,6,6,391,159,446,171,55,12
cell_r6_c7.png,6,7,446,159,502,170,56,11
cell_r6_c8.png,6,8,502,159,538,171,36,12
cell_r6_c9.png,6,9,538,160,570,171,32,11
cell_r6_c10.png,6,10,570,159,626,171,56,12
cell_r6_c11.png,6,11,626,159,698,171,72,12
cell_r6_c12.png,6,12,698,160,734,171,36,11
cell_r6_c13.png,6,13,734,159,766,171,32,12
cell_r6_c14.png,6,14,766,159,822,171,56,12
cell_r6_c15.png,6,15,822,160,887,171,65,11
cell_r6_c16.png,6,16,887,160,919,171,32,11
cell_r6_c17.png,6,17,919,160,985,171,66,11
cell_r6_c18.png,6,18,985,160,1050,171,65,11
cell_r6_c0.png,6,0,1,158,16,170,15,12
cell_r6_c1.png,6,1,16,158,229,170,213,12
cell_r6_c2.png,6,2,229,159,280,170,51,11
cell_r6_c3.png,6,3,280,159,324,170,44,11
cell_r6_c4.png,6,4,323,159,359,170,36,11
cell_r6_c5.png,6,5,359,159,391,171,32,12
cell_r6_c6.png,6,6,391,159,446,171,55,12
cell_r6_c7.png,6,7,446,159,502,170,56,11
cell_r6_c8.png,6,8,502,159,538,171,36,12
cell_r6_c9.png,6,9,538,160,570,171,32,11
cell_r6_c10.png,6,10,570,159,626,171,56,12
cell_r6_c11.png,6,11,626,159,698,171,72,12
cell_r6_c12.png,6,12,698,160,734,171,36,11
cell_r6_c13.png,6,13,734,159,766,171,32,12
cell_r6_c14.png,6,14,766,159,822,171,56,12
cell_r6_c15.png,6,15,822,160,887,171,65,11
cell_r6_c16.png,6,16,887,160,919,171,32,11
cell_r6_c17.png,6,17,919,160,985,171,66,11
cell_r6_c18.png,6,18,985,160,1050,171,65,11
cell_r6_c0.png,6,0,1,158,16,170,15,12
cell_r6_c1.png,6,1,16,158,229,170,213,12
cell_r6_c2.png,6,2,229,159,280,170,51,11
cell_r6_c3.png,6,3,280,159,324,170,44,11
cell_r6_c4.png,6,4,323,159,359,170,36,11
cell_r6_c5.png,6,5,359,159,391,171,32,12
cell_r6_c6.png,6,6,391,159,446,171,55,12
cell_r6_c7.png,6,7,446,159,502,170,56,11
cell_r6_c8.png,6,8,502,159,538,171,36,12
cell_r6_c9.png,6,9,538,160,570,171,32,11
cell_r6_c10.png,6,10,570,159,626,171,56,12
cell_r6_c11.png,6,11,626,159,698,171,72,12
cell_r6_c12.png,6,12,698,160,734,171,36,11
cell_r6_c13.png,6,13,734,159,766,171,32,12
cell_r6_c14.png,6,14,766,159,822,171,56,12
cell_r6_c15.png,6,15,822,160,887,171,65,11
cell_r6_c16.png,6,16,887,160,919,171,32,11
cell_r6_c17.png,6,17,919,160,985,171,66,11
cell_r6_c18.png,6,18,985,160,1050,171,65,11
cell_r6_c0.png,6,0,1,158,16,170,15,12
cell_r6_c1.png,6,1,16,158,229,170,213,12
cell_r6_c2.png,6,2,229,159,280,170,51,11
cell_r6_c3.png,6,3,280,159,324,170,44,11
cell_r6_c4.png,6,4,323,159,359,170,36,11
cell_r6_c5.png,6,5,359,159,391,171,32,12
cell_r6_c6.png,6,6,391,159,446,171,55,12
cell_r6_c7.png,6,7,446,159,502,170,56,11
cell_r6_c8.png,6,8,502,159,538,171,36,12
cell_r6_c9.png,6,9,538,160,570,171,32,11
cell_r6_c10.png,6,10,570,159,626,171,56,12
cell_r6_c11.png,6,11,626,159,698,171,72,12
cell_r6_c12.png,6,12,698,160,734,171,36,11
cell_r6_c13.png,6,13,734,159,766,171,32,12
cell_r6_c14.png,6,14,766,159,822,171,56,12
cell_r6_c15.png,6,15,822,160,887,171,65,11
cell_r6_c16.png,6,16,887,160,919,171,32,11
cell_r6_c17.png,6,17,919,160,985,171,66,11
cell_r6_c18.png,6,18,985,160,1050,171,65,11
cell_r6_c0.png,6,0,1,158,16,170,15,12
cell_r6_c1.png,6,1,16,158,229,170,213,12
cell_r6_c2.png,6,2,229,159,280,170,51,11
cell_r6_c3.png,6,3,280,159,324,170,44,11
cell_r6_c4.png,6,4,323,159,359,170,36,11
cell_r6_c5.png,6,5,359,159,391,171,32,12
cell_r6_c6.png,6,6,391,159,446,171,55,12
cell_r6_c7.png,6,7,446,159,502,170,56,11
cell_r6_c8.png,6,8,502,159,538,171,36,12
cell_r6_c9.png,6,9,538,160,570,171,32,11
cell_r6_c10.png,6,10,570,159,626,171,56,12
cell_r6_c11.png,6,11,626,159,698,171,72,12
cell_r6_c12.png,6,12,698,160,734,171,36,11
cell_r6_c13.png,6,13,734,159,766,171,32,12
cell_r6_c14.png,6,14,766,159,822,171,56,12
cell_r6_c15.png,6,15,822,160,887,171,65,11
cell_r6_c16.png,6,16,887,160,919,171,32,11
cell_r6_c17.png,6,17,919,160,985,171,66,11
cell_r6_c18.png,6,18,985,160,1050,171,65,11
cell_r6_c0.png,6,0,1,158,16,170,15,12
cell_r6_c1.png,6,1,16,158,229,170,213,12
cell_r6_c2.png,6,2,229,159,280,170,51,11
cell_r6_c3.png,6,3,280,159,324,170,44,11
cell_r6_c4.png,6,4,323,159,359,170,36,11
cell_r6_c5.png,6,5,359,159,391,171,32,12
cell_r6_c6.png,6,6,391,159,446,171,55,12
cell_r6_c7.png,6,7,446,159,502,170,56,11
cell_r6_c8.png,6,8,502,159,538,171,36,12
cell_r6_c9.png,6,9,538,160,570,171,32,11
cell_r6_c10.png,6,10,570,159,626,171,56,12
cell_r6_c11.png,6,11,626,159,698,171,72,12
cell_r6_c12.png,6,12,698,160,734,171,36,11
cell_r6_c13.png,6,13,734,159,766,171,32,12
cell_r6_c14.png,6,14,766,159,822,171,56,12
cell_r6_c15.png,6,15,822,160,887,171,65,11
cell_r6_c16.png,6,16,887,160,919,171,32,11
cell_r6_c17.png,6,17,919,160,985,171,66,11
cell_r6_c18.png,6,18,985,160,1050,171,65,11
cell_r6_c0.png,6,0,1,158,16,170,15,12
cell_r6_c1.png,6,1,16,158,229,170,213,12
cell_r6_c2.png,6,2,229,159,280,170,51,11
cell_r6_c3.png,6,3,280,159,324,170,44,11
cell_r6_c4.png,6,4,323,159,359,170,36,11
cell_r6_c5.png,6,5,359,159,391,171,32,12
cell_r6_c6.png,6,6,391,159,446,171,55,12
cell_r6_c7.png,6,7,446,159,502,170,56,11
cell_r6_c8.png,6,8,502,159,538,171,36,12
cell_r6_c9.png,6,9,538,160,570,171,32,11
cell_r6_c10.png,6,10,570,159,626,171,56,12
cell_r6_c11.png,6,11,626,159,698,171,72,12
cell_r6_c12.png,6,12,698,160,734,171,36,11
cell_r6_c13.png,6,13,734,159,766,171,32,12
cell_r6_c14.png,6,14,766,159,822,171,56,12
cell_r6_c15.png,6,15,822,160,887,171,65,11
cell_r6_c16.png,6,16,887,160,919,171,32,11
cell_r6_c17.png,6,17,919,160,985,171,66,11
cell_r6_c18.png,6,18,985,160,1050,171,65,11
cell_r6_c0.png,6,0,1,158,16,170,15,12
cell_r6_c1.png,6,1,16,158,229,170,213,12
cell_r6_c2.png,6,2,229,159,280,170,51,11
cell_r6_c3.png,6,3,280,159,324,170,44,11
cell_r6_c4.png,6,4,323,159,359,170,36,11
cell_r6_c5.png,6,5,359,159,391,171,32,12
cell_r6_c6.png,6,6,391,159,446,171,55,12
cell_r6_c7.png,6,7,446,159,502,170,56,11
cell_r6_c8.png,6,8,502,159,538,171,36,12
cell_r6_c9.png,6,9,538,160,570,171,32,11
cell_r6_c10.png,6,10,570,159,626,171,56,12
cell_r6_c11.png,6,11,626,159,698,171,72,12
cell_r6_c12.png,6,12,698,160,734,171,36,11
cell_r6_c13.png,6,13,734,159,766,171,32,12
cell_r6_c14.png,6,14,766,159,822,171,56,12
cell_r6_c15.png,6,15,822,160,887,171,65,11
cell_r6_c16.png,6,16,887,160,919,171,32,11
cell_r6_c17.png,6,17,919,160,985,171,66,11
cell_r6_c18.png,6,18,985,160,1050,171,65,11
cell_r6_c0.png,6,0,1,158,16,170,15,12
cell_r6_c1.png,6,1,16,158,229,170,213,12
cell_r6_c2.png,6,2,229,159,280,170,51,11
cell_r6_c3.png,6,3,280,159,324,170,44,11
cell_r6_c4.png,6,4,323,159,359,170,36,11
cell_r6_c5.png,6,5,359,159,391,171,32,12
cell_r6_c6.png,6,6,391,159,446,171,55,12
cell_r6_c7.png,6,7,446,159,502,170,56,11
cell_r6_c8.png,6,8,502,159,538,171,36,12
cell_r6_c9.png,6,9,538,160,570,171,32,11
cell_r6_c10.png,6,10,570,159,626,171,56,12
cell_r6_c11.png,6,11,626,159,698,171,72,12
cell_r6_c12.png,6,12,698,160,734,171,36,11
cell_r6_c13.png,6,13,734,159,766,171,32,12
cell_r6_c14.png,6,14,766,159,822,171,56,12
cell_r6_c15.png,6,15,822,160,887,171,65,11
cell_r6_c16.png,6,16,887,160,919,171,32,11
cell_r6_c17.png,6,17,919,160,985,171,66,11
cell_r6_c18.png,6,18,985,160,1050,171,65,11
cell_r6_c0.png,6,0,1,158,16,170,15,12
cell_r6_c1.png,6,1,16,158,229,170,213,12
cell_r6_c2.png,6,2,229,159,280,170,51,11
cell_r6_c3.png,6,3,280,159,324,170,44,11
cell_r6_c4.png,6,4,323,159,359,170,36,11
cell_r6_c5.png,6,5,359,159,391,171,32,12
cell_r6_c6.png,6,6,391,159,446,171,55,12
cell_r6_c7.png,6,7,446,159,502,170,56,11
cell_r6_c8.png,6,8,502,159,538,171,36,12
cell_r6_c9.png,6,9,538,160,570,171,32,11
cell_r6_c10.png,6,10,570,159,626,171,56,12
cell_r6_c11.png,6,11,626,159,698,171,72,12
cell_r6_c12.png,6,12,698,160,734,171,36,11
cell_r6_c13.png,6,13,734,159,766,171,32,12
cell_r6_c14.png,6,14,766,159,822,171,56,12
cell_r6_c15.png,6,15,822,160,887,171,65,11
cell_r6_c16.png,6,16,887,160,919,171,32,11
cell_r6_c17.png,6,17,919,160,985,171,66,11
cell_r6_c18.png,6,18,985,160,1050,171,65,11
cell_r6_c0.png,6,0,1,158,16,170,15,12
cell_r6_c1.png,6,1,16,158,229,170,213,12
cell_r6_c2.png,6,2,229,159,280,170,51,11
cell_r6_c3.png,6,3,280,159,324,170,44,11
cell_r6_c4.png,6,4,323,159,359,170,36,11
cell_r6_c5.png,6,5,359,159,391,171,32,12
cell_r6_c6.png,6,6,391,159,446,171,55,12
cell_r6_c7.png,6,7,446,159,502,170,56,11
cell_r6_c8.png,6,8,502,159,538,171,36,12
cell_r6_c9.png,6,9,538,160,570,171,32,11
cell_r6_c10.png,6,10,570,159,626,171,56,12
cell_r6_c11.png,6,11,626,159,698,171,72,12
cell_r6_c12.png,6,12,698,160,734,171,36,11
cell_r6_c13.png,6,13,734,159,766,171,32,12
cell_r6_c14.png,6,14,766,159,822,171,56,12
cell_r6_c15.png,6,15,822,160,887,171,65,11
cell_r6_c16.png,6,16,887,160,919,171,32,11
cell_r6_c17.png,6,17,919,160,985,171,66,11
cell_r6_c18.png,6,18,985,160,1050,171,65,11
cell_r6_c0.png,6,0,1,158,16,170,15,12
cell_r6_c1.png,6,1,16,158,229,170,213,12
cell_r6_c2.png,6,2,229,159,280,170,51,11
cell_r6_c3.png,6,3,280,159,324,170,44,11
cell_r6_c4.png,6,4,323,159,359,170,36,11
cell_r6_c5.png,6,5,359,159,391,171,32,12
cell_r6_c6.png,6,6,391,159,446,171,55,12
cell_r6_c7.png,6,7,446,159,502,170,56,11
cell_r6_c8.png,6,8,502,159,538,171,36,12
cell_r6_c9.png,6,9,538,160,570,171,32,11
cell_r6_c10.png,6,10,570,159,626,171,56,12
cell_r6_c11.png,6,11,626,159,698,171,72,12
cell_r6_c12.png,6,12,698,160,734,171,36,11
cell_r6_c13.png,6,13,734,159,766,171,32,12
cell_r6_c14.png,6,14,766,159,822,171,56,12
cell_r6_c15.png,6,15,822,160,887,171,65,11
cell_r6_c16.png,6,16,887,160,919,171,32,11
cell_r6_c17.png,6,17,919,160,985,171,66,11
cell_r6_c18.png,6,18,985,160,1050,171,65,11
cell_r6_c0.png,6,0,1,158,16,170,15,12
cell_r6_c1.png,6,1,16,158,229,170,213,12
cell_r6_c2.png,6,2,229,159,280,170,51,11
cell_r6_c3.png,6,3,280,159,324,170,44,11
cell_r6_c4.png,6,4,323,159,359,170,36,11
cell_r6_c5.png,6,5,359,159,391,171,32,12
cell_r6_c6.png,6,6,391,159,446,171,55,12
cell_r6_c7.png,6,7,446,159,502,170,56,11
cell_r6_c8.png,6,8,502,159,538,171,36,12
cell_r6_c9.png,6,9,538,160,570,171,32,11
cell_r6_c10.png,6,10,570,159,626,171,56,12
cell_r6_c11.png,6,11,626,159,698,171,72,12
cell_r6_c12.png,6,12,698,160,734,171,36,11
cell_r6_c13.png,6,13,734,159,766,171,32,12
cell_r6_c14.png,6,14,766,159,822,171,56,12
cell_r6_c15.png,6,15,822,160,887,171,65,11
cell_r6_c16.png,6,16,887,160,919,171,32,11
cell_r6_c17.png,6,17,919,160,985,171,66,11
cell_r6_c18.png,6,18,985,160,1050,171,65,11
cell_r6_c0.png,6,0,1,158,16,170,15,12
cell_r6_c1.png,6,1,16,158,229,170,213,12
cell_r6_c2.png,6,2,229,159,280,170,51,11
cell_r6_c3.png,6,3,280,159,324,170,44,11
cell_r6_c4.png,6,4,323,159,359,170,36,11
cell_r6_c5.png,6,5,359,159,391,171,32,12
cell_r6_c6.png,6,6,391,159,446,171,55,12
cell_r6_c7.png,6,7,446,159,502,170,56,11
cell_r6_c8.png,6,8,502,159,538,171,36,12
cell_r6_c9.png,6,9,538,160,570,171,32,11
cell_r6_c10.png,6,10,570,159,626,171,56,12
cell_r6_c11.png,6,11,626,159,698,171,72,12
cell_r6_c12.png,6,12,698,160,734,171,36,11
cell_r6_c13.png,6,13,734,159,766,171,32,12
cell_r6_c14.png,6,14,766,159,822,171,56,12
cell_r6_c15.png,6,15,822,160,887,171,65,11
cell_r6_c16.png,6,16,887,160,919,171,32,11
cell_r6_c17.png,6,17,919,160,985,171,66,11
cell_r6_c18.png,6,18,985,160,1050,171,65,11
cell_r7_c0.png,7,0,1,170,16,181,15,11
cell_r7_c1.png,7,1,16,170,229,182,213,12
cell_r7_c2.png,7,2,229,170,280,182,51,12
cell_r7_c3.png,7,3,280,170,323,182,43,12
cell_r7_c4.png,7,4,323,170,359,182,36,12
cell_r7_c5.png,7,5,359,170,391,182,32,12
cell_r7_c6.png,7,6,391,170,446,182,55,12
cell_r7_c7.png,7,7,445,170,502,182,57,12
cell_r7_c8.png,7,8,502,170,538,182,36,12
cell_r7_c9.png,7,9,538,171,570,182,32,11
cell_r7_c10.png,7,10,570,170,627,182,57,12
cell_r7_c11.png,7,11,626,170,698,182,72,12
cell_r7_c12.png,7,12,698,171,734,182,36,11
cell_r7_c13.png,7,13,734,171,766,182,32,11
cell_r7_c14.png,7,14,766,171,822,182,56,11
cell_r7_c15.png,7,15,822,171,887,182,65,11
cell_r7_c16.png,7,16,887,171,919,183,32,12
cell_r7_c17.png,7,17,919,171,985,183,66,12
cell_r7_c18.png,7,18,985,171,1050,182,65,11
cell_r7_c0.png,7,0,1,170,16,181,15,11
cell_r7_c1.png,7,1,16,170,229,182,213,12
cell_r7_c2.png,7,2,229,170,280,182,51,12
cell_r7_c3.png,7,3,280,170,323,182,43,12
cell_r7_c4.png,7,4,323,170,359,182,36,12
cell_r7_c5.png,7,5,359,170,391,182,32,12
cell_r7_c6.png,7,6,391,170,446,182,55,12
cell_r7_c7.png,7,7,445,170,502,182,57,12
cell_r7_c8.png,7,8,502,170,538,182,36,12
cell_r7_c9.png,7,9,538,171,570,182,32,11
cell_r7_c10.png,7,10,570,170,627,182,57,12
cell_r7_c11.png,7,11,626,170,698,182,72,12
cell_r7_c12.png,7,12,698,171,734,182,36,11
cell_r7_c13.png,7,13,734,171,766,182,32,11
cell_r7_c14.png,7,14,766,171,822,182,56,11
cell_r7_c15.png,7,15,822,171,887,182,65,11
cell_r7_c16.png,7,16,887,171,919,183,32,12
cell_r7_c17.png,7,17,919,171,985,183,66,12
cell_r7_c18.png,7,18,985,171,1050,182,65,11
cell_r7_c0.png,7,0,1,170,16,181,15,11
cell_r7_c1.png,7,1,16,170,229,182,213,12
cell_r7_c2.png,7,2,229,170,280,182,51,12
cell_r7_c3.png,7,3,280,170,323,182,43,12
cell_r7_c4.png,7,4,323,170,359,182,36,12
cell_r7_c5.png,7,5,359,170,391,182,32,12
cell_r7_c6.png,7,6,391,170,446,182,55,12
cell_r7_c7.png,7,7,445,170,502,182,57,12
cell_r7_c8.png,7,8,502,170,538,182,36,12
cell_r7_c9.png,7,9,538,171,570,182,32,11
cell_r7_c10.png,7,10,570,170,627,182,57,12
cell_r7_c11.png,7,11,626,170,698,182,72,12
cell_r7_c12.png,7,12,698,171,734,182,36,11
cell_r7_c13.png,7,13,734,171,766,182,32,11
cell_r7_c14.png,7,14,766,171,822,182,56,11
cell_r7_c15.png,7,15,822,171,887,182,65,11
cell_r7_c16.png,7,16,887,171,919,183,32,12
cell_r7_c17.png,7,17,919,171,985,183,66,12
cell_r7_c18.png,7,18,985,171,1050,182,65,11
cell_r7_c0.png,7,0,1,170,16,181,15,11
cell_r7_c1.png,7,1,16,170,229,182,213,12
cell_r7_c2.png,7,2,229,170,280,182,51,12
cell_r7_c3.png,7,3,280,170,323,182,43,12
cell_r7_c4.png,7,4,323,170,359,182,36,12
cell_r7_c5.png,7,5,359,170,391,182,32,12
cell_r7_c6.png,7,6,391,170,446,182,55,12
cell_r7_c7.png,7,7,445,170,502,182,57,12
cell_r7_c8.png,7,8,502,170,538,182,36,12
cell_r7_c9.png,7,9,538,171,570,182,32,11
cell_r7_c10.png,7,10,570,170,627,182,57,12
cell_r7_c11.png,7,11,626,170,698,182,72,12
cell_r7_c12.png,7,12,698,171,734,182,36,11
cell_r7_c13.png,7,13,734,171,766,182,32,11
cell_r7_c14.png,7,14,766,171,822,182,56,11
cell_r7_c15.png,7,15,822,171,887,182,65,11
cell_r7_c16.png,7,16,887,171,919,183,32,12
cell_r7_c17.png,7,17,919,171,985,183,66,12
cell_r7_c18.png,7,18,985,171,1050,182,65,11
cell_r7_c0.png,7,0,1,170,16,181,15,11
cell_r7_c1.png,7,1,16,170,229,182,213,12
cell_r7_c2.png,7,2,229,170,280,182,51,12
cell_r7_c3.png,7,3,280,170,323,182,43,12
cell_r7_c4.png,7,4,323,170,359,182,36,12
cell_r7_c5.png,7,5,359,170,391,182,32,12
cell_r7_c6.png,7,6,391,170,446,182,55,12
cell_r7_c7.png,7,7,445,170,502,182,57,12
cell_r7_c8.png,7,8,502,170,538,182,36,12
cell_r7_c9.png,7,9,538,171,570,182,32,11
cell_r7_c10.png,7,10,570,170,627,182,57,12
cell_r7_c11.png,7,11,626,170,698,182,72,12
cell_r7_c12.png,7,12,698,171,734,182,36,11
cell_r7_c13.png,7,13,734,171,766,182,32,11
cell_r7_c14.png,7,14,766,171,822,182,56,11
cell_r7_c15.png,7,15,822,171,887,182,65,11
cell_r7_c16.png,7,16,887,171,919,183,32,12
cell_r7_c17.png,7,17,919,171,985,183,66,12
cell_r7_c18.png,7,18,985,171,1050,182,65,11
cell_r7_c0.png,7,0,1,170,16,181,15,11
cell_r7_c1.png,7,1,16,170,229,182,213,12
cell_r7_c2.png,7,2,229,170,280,182,51,12
cell_r7_c3.png,7,3,280,170,323,182,43,12
cell_r7_c4.png,7,4,323,170,359,182,36,12
cell_r7_c5.png,7,5,359,170,391,182,32,12
cell_r7_c6.png,7,6,391,170,446,182,55,12
cell_r7_c7.png,7,7,445,170,502,182,57,12
cell_r7_c8.png,7,8,502,170,538,182,36,12
cell_r7_c9.png,7,9,538,171,570,182,32,11
cell_r7_c10.png,7,10,570,170,627,182,57,12
cell_r7_c11.png,7,11,626,170,698,182,72,12
cell_r7_c12.png,7,12,698,171,734,182,36,11
cell_r7_c13.png,7,13,734,171,766,182,32,11
cell_r7_c14.png,7,14,766,171,822,182,56,11
cell_r7_c15.png,7,15,822,171,887,182,65,11
cell_r7_c16.png,7,16,887,171,919,183,32,12
cell_r7_c17.png,7,17,919,171,985,183,66,12
cell_r7_c18.png,7,18,985,171,1050,182,65,11
cell_r7_c0.png,7,0,1,170,16,181,15,11
cell_r7_c1.png,7,1,16,170,229,182,213,12
cell_r7_c2.png,7,2,229,170,280,182,51,12
cell_r7_c3.png,7,3,280,170,323,182,43,12
cell_r7_c4.png,7,4,323,170,359,182,36,12
cell_r7_c5.png,7,5,359,170,391,182,32,12
cell_r7_c6.png,7,6,391,170,446,182,55,12
cell_r7_c7.png,7,7,445,170,502,182,57,12
cell_r7_c8.png,7,8,502,170,538,182,36,12
cell_r7_c9.png,7,9,538,171,570,182,32,11
cell_r7_c10.png,7,10,570,170,627,182,57,12
cell_r7_c11.png,7,11,626,170,698,182,72,12
cell_r7_c12.png,7,12,698,171,734,182,36,11
cell_r7_c13.png,7,13,734,171,766,182,32,11
cell_r7_c14.png,7,14,766,171,822,182,56,11
cell_r7_c15.png,7,15,822,171,887,182,65,11
cell_r7_c16.png,7,16,887,171,919,183,32,12
cell_r7_c17.png,7,17,919,171,985,183,66,12
cell_r7_c18.png,7,18,985,171,1050,182,65,11
cell_r7_c0.png,7,0,1,170,16,181,15,11
cell_r7_c1.png,7,1,16,170,229,182,213,12
cell_r7_c2.png,7,2,229,170,280,182,51,12
cell_r7_c3.png,7,3,280,170,323,182,43,12
cell_r7_c4.png,7,4,323,170,359,182,36,12
cell_r7_c5.png,7,5,359,170,391,182,32,12
cell_r7_c6.png,7,6,391,170,446,182,55,12
cell_r7_c7.png,7,7,445,170,502,182,57,12
cell_r7_c8.png,7,8,502,170,538,182,36,12
cell_r7_c9.png,7,9,538,171,570,182,32,11
cell_r7_c10.png,7,10,570,170,627,182,57,12
cell_r7_c11.png,7,11,626,170,698,182,72,12
cell_r7_c12.png,7,12,698,171,734,182,36,11
cell_r7_c13.png,7,13,734,171,766,182,32,11
cell_r7_c14.png,7,14,766,171,822,182,56,11
cell_r7_c15.png,7,15,822,171,887,182,65,11
cell_r7_c16.png,7,16,887,171,919,183,32,12
cell_r7_c17.png,7,17,919,171,985,183,66,12
cell_r7_c18.png,7,18,985,171,1050,182,65,11
cell_r7_c0.png,7,0,1,170,16,181,15,11
cell_r7_c1.png,7,1,16,170,229,182,213,12
cell_r7_c2.png,7,2,229,170,280,182,51,12
cell_r7_c3.png,7,3,280,170,323,182,43,12
cell_r7_c4.png,7,4,323,170,359,182,36,12
cell_r7_c5.png,7,5,359,170,391,182,32,12
cell_r7_c6.png,7,6,391,170,446,182,55,12
cell_r7_c7.png,7,7,445,170,502,182,57,12
cell_r7_c8.png,7,8,502,170,538,182,36,12
cell_r7_c9.png,7,9,538,171,570,182,32,11
cell_r7_c10.png,7,10,570,170,627,182,57,12
cell_r7_c11.png,7,11,626,170,698,182,72,12
cell_r7_c12.png,7,12,698,171,734,182,36,11
cell_r7_c13.png,7,13,734,171,766,182,32,11
cell_r7_c14.png,7,14,766,171,822,182,56,11
cell_r7_c15.png,7,15,822,171,887,182,65,11
cell_r7_c16.png,7,16,887,171,919,183,32,12
cell_r7_c17.png,7,17,919,171,985,183,66,12
cell_r7_c18.png,7,18,985,171,1050,182,65,11
cell_r7_c0.png,7,0,1,170,16,181,15,11
cell_r7_c1.png,7,1,16,170,229,182,213,12
cell_r7_c2.png,7,2,229,170,280,182,51,12
cell_r7_c3.png,7,3,280,170,323,182,43,12
cell_r7_c4.png,7,4,323,170,359,182,36,12
cell_r7_c5.png,7,5,359,170,391,182,32,12
cell_r7_c6.png,7,6,391,170,446,182,55,12
cell_r7_c7.png,7,7,445,170,502,182,57,12
cell_r7_c8.png,7,8,502,170,538,182,36,12
cell_r7_c9.png,7,9,538,171,570,182,32,11
cell_r7_c10.png,7,10,570,170,627,182,57,12
cell_r7_c11.png,7,11,626,170,698,182,72,12
cell_r7_c12.png,7,12,698,171,734,182,36,11
cell_r7_c13.png,7,13,734,171,766,182,32,11
cell_r7_c14.png,7,14,766,171,822,182,56,11
cell_r7_c15.png,7,15,822,171,887,182,65,11
cell_r7_c16.png,7,16,887,171,919,183,32,12
cell_r7_c17.png,7,17,919,171,985,183,66,12
cell_r7_c18.png,7,18,985,171,1050,182,65,11
cell_r7_c0.png,7,0,1,170,16,181,15,11
cell_r7_c1.png,7,1,16,170,229,182,213,12
cell_r7_c2.png,7,2,229,170,280,182,51,12
cell_r7_c3.png,7,3,280,170,323,182,43,12
cell_r7_c4.png,7,4,323,170,359,182,36,12
cell_r7_c5.png,7,5,359,170,391,182,32,12
cell_r7_c6.png,7,6,391,170,446,182,55,12
cell_r7_c7.png,7,7,445,170,502,182,57,12
cell_r7_c8.png,7,8,502,170,538,182,36,12
cell_r7_c9.png,7,9,538,171,570,182,32,11
cell_r7_c10.png,7,10,570,170,627,182,57,12
cell_r7_c11.png,7,11,626,170,698,182,72,12
cell_r7_c12.png,7,12,698,171,734,182,36,11
cell_r7_c13.png,7,13,734,171,766,182,32,11
cell_r7_c14.png,7,14,766,171,822,182,56,11
cell_r7_c15.png,7,15,822,171,887,182,65,11
cell_r7_c16.png,7,16,887,171,919,183,32,12
cell_r7_c17.png,7,17,919,171,985,183,66,12
cell_r7_c18.png,7,18,985,171,1050,182,65,11
cell_r7_c0.png,7,0,1,170,16,181,15,11
cell_r7_c1.png,7,1,16,170,229,182,213,12
cell_r7_c2.png,7,2,229,170,280,182,51,12
cell_r7_c3.png,7,3,280,170,323,182,43,12
cell_r7_c4.png,7,4,323,170,359,182,36,12
cell_r7_c5.png,7,5,359,170,391,182,32,12
cell_r7_c6.png,7,6,391,170,446,182,55,12
cell_r7_c7.png,7,7,445,170,502,182,57,12
cell_r7_c8.png,7,8,502,170,538,182,36,12
cell_r7_c9.png,7,9,538,171,570,182,32,11
cell_r7_c10.png,7,10,570,170,627,182,57,12
cell_r7_c11.png,7,11,626,170,698,182,72,12
cell_r7_c12.png,7,12,698,171,734,182,36,11
cell_r7_c13.png,7,13,734,171,766,182,32,11
cell_r7_c14.png,7,14,766,171,822,182,56,11
cell_r7_c15.png,7,15,822,171,887,182,65,11
cell_r7_c16.png,7,16,887,171,919,183,32,12
cell_r7_c17.png,7,17,919,171,985,183,66,12
cell_r7_c18.png,7,18,985,171,1050,182,65,11
cell_r7_c0.png,7,0,1,170,16,181,15,11
cell_r7_c1.png,7,1,16,170,229,182,213,12
cell_r7_c2.png,7,2,229,170,280,182,51,12
cell_r7_c3.png,7,3,280,170,323,182,43,12
cell_r7_c4.png,7,4,323,170,359,182,36,12
cell_r7_c5.png,7,5,359,170,391,182,32,12
cell_r7_c6.png,7,6,391,170,446,182,55,12
cell_r7_c7.png,7,7,445,170,502,182,57,12
cell_r7_c8.png,7,8,502,170,538,182,36,12
cell_r7_c9.png,7,9,538,171,570,182,32,11
cell_r7_c10.png,7,10,570,170,627,182,57,12
cell_r7_c11.png,7,11,626,170,698,182,72,12
cell_r7_c12.png,7,12,698,171,734,182,36,11
cell_r7_c13.png,7,13,734,171,766,182,32,11
cell_r7_c14.png,7,14,766,171,822,182,56,11
cell_r7_c15.png,7,15,822,171,887,182,65,11
cell_r7_c16.png,7,16,887,171,919,183,32,12
cell_r7_c17.png,7,17,919,171,985,183,66,12
cell_r7_c18.png,7,18,985,171,1050,182,65,11
cell_r7_c0.png,7,0,1,170,16,181,15,11
cell_r7_c1.png,7,1,16,170,229,182,213,12
cell_r7_c2.png,7,2,229,170,280,182,51,12
cell_r7_c3.png,7,3,280,170,323,182,43,12
cell_r7_c4.png,7,4,323,170,359,182,36,12
cell_r7_c5.png,7,5,359,170,391,182,32,12
cell_r7_c6.png,7,6,391,170,446,182,55,12
cell_r7_c7.png,7,7,445,170,502,182,57,12
cell_r7_c8.png,7,8,502,170,538,182,36,12
cell_r7_c9.png,7,9,538,171,570,182,32,11
cell_r7_c10.png,7,10,570,170,627,182,57,12
cell_r7_c11.png,7,11,626,170,698,182,72,12
cell_r7_c12.png,7,12,698,171,734,182,36,11
cell_r7_c13.png,7,13,734,171,766,182,32,11
cell_r7_c14.png,7,14,766,171,822,182,56,11
cell_r7_c15.png,7,15,822,171,887,182,65,11
cell_r7_c16.png,7,16,887,171,919,183,32,12
cell_r7_c17.png,7,17,919,171,985,183,66,12
cell_r7_c18.png,7,18,985,171,1050,182,65,11
cell_r7_c0.png,7,0,1,170,16,181,15,11
cell_r7_c1.png,7,1,16,170,229,182,213,12
cell_r7_c2.png,7,2,229,170,280,182,51,12
cell_r7_c3.png,7,3,280,170,323,182,43,12
cell_r7_c4.png,7,4,323,170,359,182,36,12
cell_r7_c5.png,7,5,359,170,391,182,32,12
cell_r7_c6.png,7,6,391,170,446,182,55,12
cell_r7_c7.png,7,7,445,170,502,182,57,12
cell_r7_c8.png,7,8,502,170,538,182,36,12
cell_r7_c9.png,7,9,538,171,570,182,32,11
cell_r7_c10.png,7,10,570,170,627,182,57,12
cell_r7_c11.png,7,11,626,170,698,182,72,12
cell_r7_c12.png,7,12,698,171,734,182,36,11
cell_r7_c13.png,7,13,734,171,766,182,32,11
cell_r7_c14.png,7,14,766,171,822,182,56,11
cell_r7_c15.png,7,15,822,171,887,182,65,11
cell_r7_c16.png,7,16,887,171,919,183,32,12
cell_r7_c17.png,7,17,919,171,985,183,66,12
cell_r7_c18.png,7,18,985,171,1050,182,65,11
cell_r7_c0.png,7,0,1,170,16,181,15,11
cell_r7_c1.png,7,1,16,170,229,182,213,12
cell_r7_c2.png,7,2,229,170,280,182,51,12
cell_r7_c3.png,7,3,280,170,323,182,43,12
cell_r7_c4.png,7,4,323,170,359,182,36,12
cell_r7_c5.png,7,5,359,170,391,182,32,12
cell_r7_c6.png,7,6,391,170,446,182,55,12
cell_r7_c7.png,7,7,445,170,502,182,57,12
cell_r7_c8.png,7,8,502,170,538,182,36,12
cell_r7_c9.png,7,9,538,171,570,182,32,11
cell_r7_c10.png,7,10,570,170,627,182,57,12
cell_r7_c11.png,7,11,626,170,698,182,72,12
cell_r7_c12.png,7,12,698,171,734,182,36,11
cell_r7_c13.png,7,13,734,171,766,182,32,11
cell_r7_c14.png,7,14,766,171,822,182,56,11
cell_r7_c15.png,7,15,822,171,887,182,65,11
cell_r7_c16.png,7,16,887,171,919,183,32,12
cell_r7_c17.png,7,17,919,171,985,183,66,12
cell_r7_c18.png,7,18,985,171,1050,182,65,11
cell_r7_c0.png,7,0,1,170,16,181,15,11
cell_r7_c1.png,7,1,16,170,229,182,213,12
cell_r7_c2.png,7,2,229,170,280,182,51,12
cell_r7_c3.png,7,3,280,170,323,182,43,12
cell_r7_c4.png,7,4,323,170,359,182,36,12
cell_r7_c5.png,7,5,359,170,391,182,32,12
cell_r7_c6.png,7,6,391,170,446,182,55,12
cell_r7_c7.png,7,7,445,170,502,182,57,12
cell_r7_c8.png,7,8,502,170,538,182,36,12
cell_r7_c9.png,7,9,538,171,570,182,32,11
cell_r7_c10.png,7,10,570,170,627,182,57,12
cell_r7_c11.png,7,11,626,170,698,182,72,12
cell_r7_c12.png,7,12,698,171,734,182,36,11
cell_r7_c13.png,7,13,734,171,766,182,32,11
cell_r7_c14.png,7,14,766,171,822,182,56,11
cell_r7_c15.png,7,15,822,171,887,182,65,11
cell_r7_c16.png,7,16,887,171,919,183,32,12
cell_r7_c17.png,7,17,919,171,985,183,66,12
cell_r7_c18.png,7,18,985,171,1050,182,65,11
cell_r7_c0.png,7,0,1,170,16,181,15,11
cell_r7_c1.png,7,1,16,170,229,182,213,12
cell_r7_c2.png,7,2,229,170,280,182,51,12
cell_r7_c3.png,7,3,280,170,323,182,43,12
cell_r7_c4.png,7,4,323,170,359,182,36,12
cell_r7_c5.png,7,5,359,170,391,182,32,12
cell_r7_c6.png,7,6,391,170,446,182,55,12
cell_r7_c7.png,7,7,445,170,502,182,57,12
cell_r7_c8.png,7,8,502,170,538,182,36,12
cell_r7_c9.png,7,9,538,171,570,182,32,11
cell_r7_c10.png,7,10,570,170,627,182,57,12
cell_r7_c11.png,7,11,626,170,698,182,72,12
cell_r7_c12.png,7,12,698,171,734,182,36,11
cell_r7_c13.png,7,13,734,171,766,182,32,11
cell_r7_c14.png,7,14,766,171,822,182,56,11
cell_r7_c15.png,7,15,822,171,887,182,65,11
cell_r7_c16.png,7,16,887,171,919,183,32,12
cell_r7_c17.png,7,17,919,171,985,183,66,12
cell_r7_c18.png,7,18,985,171,1050,182,65,11
cell_r7_c0.png,7,0,1,170,16,181,15,11
cell_r7_c1.png,7,1,16,170,229,182,213,12
cell_r7_c2.png,7,2,229,170,280,182,51,12
cell_r7_c3.png,7,3,280,170,323,182,43,12
cell_r7_c4.png,7,4,323,170,359,182,36,12
cell_r7_c5.png,7,5,359,170,391,182,32,12
cell_r7_c6.png,7,6,391,170,446,182,55,12
cell_r7_c7.png,7,7,445,170,502,182,57,12
cell_r7_c8.png,7,8,502,170,538,182,36,12
cell_r7_c9.png,7,9,538,171,570,182,32,11
cell_r7_c10.png,7,10,570,170,627,182,57,12
cell_r7_c11.png,7,11,626,170,698,182,72,12
cell_r7_c12.png,7,12,698,171,734,182,36,11
cell_r7_c13.png,7,13,734,171,766,182,32,11
cell_r7_c14.png,7,14,766,171,822,182,56,11
cell_r7_c15.png,7,15,822,171,887,182,65,11
cell_r7_c16.png,7,16,887,171,919,183,32,12
cell_r7_c17.png,7,17,919,171,985,183,66,12
cell_r7_c18.png,7,18,985,171,1050,182,65,11
cell_r8_c0.png,8,0,1,181,16,193,15,12
cell_r8_c1.png,8,1,16,181,229,193,213,12
cell_r8_c2.png,8,2,229,182,280,193,51,11
cell_r8_c3.png,8,3,280,182,323,193,43,11
cell_r8_c4.png,8,4,323,182,359,193,36,11
cell_r8_c5.png,8,5,359,182,391,193,32,11
cell_r8_c6.png,8,6,391,181,446,193,55,12
cell_r8_c7.png,8,7,445,181,502,193,57,12
cell_r8_c10.png,8,10,538,182,570,194,32,12
cell_r8_c11.png,8,11,570,182,627,194,57,12
cell_r8_c12.png,8,12,627,182,698,194,71,12
cell_r8_c13.png,8,13,698,182,734,194,36,12
cell_r8_c14.png,8,14,734,182,767,194,33,12
cell_r8_c15.png,8,15,766,182,822,194,56,12
cell_r8_c16.png,8,16,822,182,887,194,65,12
cell_r8_c17.png,8,17,887,182,919,194,32,12
cell_r8_c18.png,8,18,919,182,985,194,66,12
cell_r8_c19.png,8,19,985,182,1050,194,65,12
cell_r8_c0.png,8,0,1,181,16,193,15,12
cell_r8_c1.png,8,1,16,181,229,193,213,12
cell_r8_c2.png,8,2,229,182,280,193,51,11
cell_r8_c3.png,8,3,280,182,323,193,43,11
cell_r8_c4.png,8,4,323,182,359,193,36,11
cell_r8_c5.png,8,5,359,182,391,193,32,11
cell_r8_c6.png,8,6,391,181,446,193,55,12
cell_r8_c7.png,8,7,445,181,502,193,57,12
cell_r8_c10.png,8,10,538,182,570,194,32,12
cell_r8_c11.png,8,11,570,182,627,194,57,12
cell_r8_c12.png,8,12,627,182,698,194,71,12
cell_r8_c13.png,8,13,698,182,734,194,36,12
cell_r8_c14.png,8,14,734,182,767,194,33,12
cell_r8_c15.png,8,15,766,182,822,194,56,12
cell_r8_c16.png,8,16,822,182,887,194,65,12
cell_r8_c17.png,8,17,887,182,919,194,32,12
cell_r8_c18.png,8,18,919,182,985,194,66,12
cell_r8_c19.png,8,19,985,182,1050,194,65,12
cell_r8_c0.png,8,0,1,181,16,193,15,12
cell_r8_c1.png,8,1,16,181,229,193,213,12
cell_r8_c2.png,8,2,229,182,280,193,51,11
cell_r8_c3.png,8,3,280,182,323,193,43,11
cell_r8_c4.png,8,4,323,182,359,193,36,11
cell_r8_c5.png,8,5,359,182,391,193,32,11
cell_r8_c6.png,8,6,391,181,446,193,55,12
cell_r8_c7.png,8,7,445,181,502,193,57,12
cell_r8_c10.png,8,10,538,182,570,194,32,12
cell_r8_c11.png,8,11,570,182,627,194,57,12
cell_r8_c12.png,8,12,627,182,698,194,71,12
cell_r8_c13.png,8,13,698,182,734,194,36,12
cell_r8_c14.png,8,14,734,182,767,194,33,12
cell_r8_c15.png,8,15,766,182,822,194,56,12
cell_r8_c16.png,8,16,822,182,887,194,65,12
cell_r8_c17.png,8,17,887,182,919,194,32,12
cell_r8_c18.png,8,18,919,182,985,194,66,12
cell_r8_c19.png,8,19,985,182,1050,194,65,12
cell_r8_c0.png,8,0,1,181,16,193,15,12
cell_r8_c1.png,8,1,16,181,229,193,213,12
cell_r8_c2.png,8,2,229,182,280,193,51,11
cell_r8_c3.png,8,3,280,182,323,193,43,11
cell_r8_c4.png,8,4,323,182,359,193,36,11
cell_r8_c5.png,8,5,359,182,391,193,32,11
cell_r8_c6.png,8,6,391,181,446,193,55,12
cell_r8_c7.png,8,7,445,181,502,193,57,12
cell_r8_c10.png,8,10,538,182,570,194,32,12
cell_r8_c11.png,8,11,570,182,627,194,57,12
cell_r8_c12.png,8,12,627,182,698,194,71,12
cell_r8_c13.png,8,13,698,182,734,194,36,12
cell_r8_c14.png,8,14,734,182,767,194,33,12
cell_r8_c15.png,8,15,766,182,822,194,56,12
cell_r8_c16.png,8,16,822,182,887,194,65,12
cell_r8_c17.png,8,17,887,182,919,194,32,12
cell_r8_c18.png,8,18,919,182,985,194,66,12
cell_r8_c19.png,8,19,985,182,1050,194,65,12
cell_r8_c0.png,8,0,1,181,16,193,15,12
cell_r8_c1.png,8,1,16,181,229,193,213,12
cell_r8_c2.png,8,2,229,182,280,193,51,11
cell_r8_c3.png,8,3,280,182,323,193,43,11
cell_r8_c4.png,8,4,323,182,359,193,36,11
cell_r8_c5.png,8,5,359,182,391,193,32,11
cell_r8_c6.png,8,6,391,181,446,193,55,12
cell_r8_c7.png,8,7,445,181,502,193,57,12
cell_r8_c10.png,8,10,538,182,570,194,32,12
cell_r8_c11.png,8,11,570,182,627,194,57,12
cell_r8_c12.png,8,12,627,182,698,194,71,12
cell_r8_c13.png,8,13,698,182,734,194,36,12
cell_r8_c14.png,8,14,734,182,767,194,33,12
cell_r8_c15.png,8,15,766,182,822,194,56,12
cell_r8_c16.png,8,16,822,182,887,194,65,12
cell_r8_c17.png,8,17,887,182,919,194,32,12
cell_r8_c18.png,8,18,919,182,985,194,66,12
cell_r8_c19.png,8,19,985,182,1050,194,65,12
cell_r8_c0.png,8,0,1,181,16,193,15,12
cell_r8_c1.png,8,1,16,181,229,193,213,12
cell_r8_c2.png,8,2,229,182,280,193,51,11
cell_r8_c3.png,8,3,280,182,323,193,43,11
cell_r8_c4.png,8,4,323,182,359,193,36,11
cell_r8_c5.png,8,5,359,182,391,193,32,11
cell_r8_c6.png,8,6,391,181,446,193,55,12
cell_r8_c7.png,8,7,445,181,502,193,57,12
cell_r8_c10.png,8,10,538,182,570,194,32,12
cell_r8_c11.png,8,11,570,182,627,194,57,12
cell_r8_c12.png,8,12,627,182,698,194,71,12
cell_r8_c13.png,8,13,698,182,734,194,36,12
cell_r8_c14.png,8,14,734,182,767,194,33,12
cell_r8_c15.png,8,15,766,182,822,194,56,12
cell_r8_c16.png,8,16,822,182,887,194,65,12
cell_r8_c17.png,8,17,887,182,919,194,32,12
cell_r8_c18.png,8,18,919,182,985,194,66,12
cell_r8_c19.png,8,19,985,182,1050,194,65,12
cell_r8_c0.png,8,0,1,181,16,193,15,12
cell_r8_c1.png,8,1,16,181,229,193,213,12
cell_r8_c2.png,8,2,229,182,280,193,51,11
cell_r8_c3.png,8,3,280,182,323,193,43,11
cell_r8_c4.png,8,4,323,182,359,193,36,11
cell_r8_c5.png,8,5,359,182,391,193,32,11
cell_r8_c6.png,8,6,391,181,446,193,55,12
cell_r8_c7.png,8,7,445,181,502,193,57,12
cell_r8_c10.png,8,10,538,182,570,194,32,12
cell_r8_c11.png,8,11,570,182,627,194,57,12
cell_r8_c12.png,8,12,627,182,698,194,71,12
cell_r8_c13.png,8,13,698,182,734,194,36,12
cell_r8_c14.png,8,14,734,182,767,194,33,12
cell_r8_c15.png,8,15,766,182,822,194,56,12
cell_r8_c16.png,8,16,822,182,887,194,65,12
cell_r8_c17.png,8,17,887,182,919,194,32,12
cell_r8_c18.png,8,18,919,182,985,194,66,12
cell_r8_c19.png,8,19,985,182,1050,194,65,12
cell_r8_c0.png,8,0,1,181,16,193,15,12
cell_r8_c1.png,8,1,16,181,229,193,213,12
cell_r8_c2.png,8,2,229,182,280,193,51,11
cell_r8_c3.png,8,3,280,182,323,193,43,11
cell_r8_c4.png,8,4,323,182,359,193,36,11
cell_r8_c5.png,8,5,359,182,391,193,32,11
cell_r8_c6.png,8,6,391,181,446,193,55,12
cell_r8_c7.png,8,7,445,181,502,193,57,12
cell_r8_c10.png,8,10,538,182,570,194,32,12
cell_r8_c11.png,8,11,570,182,627,194,57,12
cell_r8_c12.png,8,12,627,182,698,194,71,12
cell_r8_c13.png,8,13,698,182,734,194,36,12
cell_r8_c14.png,8,14,734,182,767,194,33,12
cell_r8_c15.png,8,15,766,182,822,194,56,12
cell_r8_c16.png,8,16,822,182,887,194,65,12
cell_r8_c17.png,8,17,887,182,919,194,32,12
cell_r8_c18.png,8,18,919,182,985,194,66,12
cell_r8_c19.png,8,19,985,182,1050,194,65,12
cell_r8_c0.png,8,0,1,181,16,193,15,12
cell_r8_c1.png,8,1,16,181,229,193,213,12
cell_r8_c2.png,8,2,229,182,280,193,51,11
cell_r8_c3.png,8,3,280,182,323,193,43,11
cell_r8_c4.png,8,4,323,182,359,193,36,11
cell_r8_c5.png,8,5,359,182,391,193,32,11
cell_r8_c6.png,8,6,391,181,446,193,55,12
cell_r8_c7.png,8,7,445,181,502,193,57,12
cell_r8_c10.png,8,10,538,182,570,194,32,12
cell_r8_c11.png,8,11,570,182,627,194,57,12
cell_r8_c12.png,8,12,627,182,698,194,71,12
cell_r8_c13.png,8,13,698,182,734,194,36,12
cell_r8_c14.png,8,14,734,182,767,194,33,12
cell_r8_c15.png,8,15,766,182,822,194,56,12
cell_r8_c16.png,8,16,822,182,887,194,65,12
cell_r8_c17.png,8,17,887,182,919,194,32,12
cell_r8_c18.png,8,18,919,182,985,194,66,12
cell_r8_c19.png,8,19,985,182,1050,194,65,12
cell_r8_c0.png,8,0,1,181,16,193,15,12
cell_r8_c1.png,8,1,16,181,229,193,213,12
cell_r8_c2.png,8,2,229,182,280,193,51,11
cell_r8_c3.png,8,3,280,182,323,193,43,11
cell_r8_c4.png,8,4,323,182,359,193,36,11
cell_r8_c5.png,8,5,359,182,391,193,32,11
cell_r8_c6.png,8,6,391,181,446,193,55,12
cell_r8_c7.png,8,7,445,181,502,193,57,12
cell_r8_c10.png,8,10,538,182,570,194,32,12
cell_r8_c11.png,8,11,570,182,627,194,57,12
cell_r8_c12.png,8,12,627,182,698,194,71,12
cell_r8_c13.png,8,13,698,182,734,194,36,12
cell_r8_c14.png,8,14,734,182,767,194,33,12
cell_r8_c15.png,8,15,766,182,822,194,56,12
cell_r8_c16.png,8,16,822,182,887,194,65,12
cell_r8_c17.png,8,17,887,182,919,194,32,12
cell_r8_c18.png,8,18,919,182,985,194,66,12
cell_r8_c19.png,8,19,985,182,1050,194,65,12
cell_r8_c0.png,8,0,1,181,16,193,15,12
cell_r8_c1.png,8,1,16,181,229,193,213,12
cell_r8_c2.png,8,2,229,182,280,193,51,11
cell_r8_c3.png,8,3,280,182,323,193,43,11
cell_r8_c4.png,8,4,323,182,359,193,36,11
cell_r8_c5.png,8,5,359,182,391,193,32,11
cell_r8_c6.png,8,6,391,181,446,193,55,12
cell_r8_c7.png,8,7,445,181,502,193,57,12
cell_r8_c10.png,8,10,538,182,570,194,32,12
cell_r8_c11.png,8,11,570,182,627,194,57,12
cell_r8_c12.png,8,12,627,182,698,194,71,12
cell_r8_c13.png,8,13,698,182,734,194,36,12
cell_r8_c14.png,8,14,734,182,767,194,33,12
cell_r8_c15.png,8,15,766,182,822,194,56,12
cell_r8_c16.png,8,16,822,182,887,194,65,12
cell_r8_c17.png,8,17,887,182,919,194,32,12
cell_r8_c18.png,8,18,919,182,985,194,66,12
cell_r8_c19.png,8,19,985,182,1050,194,65,12
cell_r8_c0.png,8,0,1,181,16,193,15,12
cell_r8_c1.png,8,1,16,181,229,193,213,12
cell_r8_c2.png,8,2,229,182,280,193,51,11
cell_r8_c3.png,8,3,280,182,323,193,43,11
cell_r8_c4.png,8,4,323,182,359,193,36,11
cell_r8_c5.png,8,5,359,182,391,193,32,11
cell_r8_c6.png,8,6,391,181,446,193,55,12
cell_r8_c7.png,8,7,445,181,502,193,57,12
cell_r8_c10.png,8,10,538,182,570,194,32,12
cell_r8_c11.png,8,11,570,182,627,194,57,12
cell_r8_c12.png,8,12,627,182,698,194,71,12
cell_r8_c13.png,8,13,698,182,734,194,36,12
cell_r8_c14.png,8,14,734,182,767,194,33,12
cell_r8_c15.png,8,15,766,182,822,194,56,12
cell_r8_c16.png,8,16,822,182,887,194,65,12
cell_r8_c17.png,8,17,887,182,919,194,32,12
cell_r8_c18.png,8,18,919,182,985,194,66,12
cell_r8_c19.png,8,19,985,182,1050,194,65,12
cell_r8_c0.png,8,0,1,181,16,193,15,12
cell_r8_c1.png,8,1,16,181,229,193,213,12
cell_r8_c2.png,8,2,229,182,280,193,51,11
cell_r8_c3.png,8,3,280,182,323,193,43,11
cell_r8_c4.png,8,4,323,182,359,193,36,11
cell_r8_c5.png,8,5,359,182,391,193,32,11
cell_r8_c6.png,8,6,391,181,446,193,55,12
cell_r8_c7.png,8,7,445,181,502,193,57,12
cell_r8_c10.png,8,10,538,182,570,194,32,12
cell_r8_c11.png,8,11,570,182,627,194,57,12
cell_r8_c12.png,8,12,627,182,698,194,71,12
cell_r8_c13.png,8,13,698,182,734,194,36,12
cell_r8_c14.png,8,14,734,182,767,194,33,12
cell_r8_c15.png,8,15,766,182,822,194,56,12
cell_r8_c16.png,8,16,822,182,887,194,65,12
cell_r8_c17.png,8,17,887,182,919,194,32,12
cell_r8_c18.png,8,18,919,182,985,194,66,12
cell_r8_c19.png,8,19,985,182,1050,194,65,12
cell_r8_c0.png,8,0,1,181,16,193,15,12
cell_r8_c1.png,8,1,16,181,229,193,213,12
cell_r8_c2.png,8,2,229,182,280,193,51,11
cell_r8_c3.png,8,3,280,182,323,193,43,11
cell_r8_c4.png,8,4,323,182,359,193,36,11
cell_r8_c5.png,8,5,359,182,391,193,32,11
cell_r8_c6.png,8,6,391,181,446,193,55,12
cell_r8_c7.png,8,7,445,181,502,193,57,12
cell_r8_c10.png,8,10,538,182,570,194,32,12
cell_r8_c11.png,8,11,570,182,627,194,57,12
cell_r8_c12.png,8,12,627,182,698,194,71,12
cell_r8_c13.png,8,13,698,182,734,194,36,12
cell_r8_c14.png,8,14,734,182,767,194,33,12
cell_r8_c15.png,8,15,766,182,822,194,56,12
cell_r8_c16.png,8,16,822,182,887,194,65,12
cell_r8_c17.png,8,17,887,182,919,194,32,12
cell_r8_c18.png,8,18,919,182,985,194,66,12
cell_r8_c19.png,8,19,985,182,1050,194,65,12
cell_r8_c0.png,8,0,1,181,16,193,15,12
cell_r8_c1.png,8,1,16,181,229,193,213,12
cell_r8_c2.png,8,2,229,182,280,193,51,11
cell_r8_c3.png,8,3,280,182,323,193,43,11
cell_r8_c4.png,8,4,323,182,359,193,36,11
cell_r8_c5.png,8,5,359,182,391,193,32,11
cell_r8_c6.png,8,6,391,181,446,193,55,12
cell_r8_c7.png,8,7,445,181,502,193,57,12
cell_r8_c10.png,8,10,538,182,570,194,32,12
cell_r8_c11.png,8,11,570,182,627,194,57,12
cell_r8_c12.png,8,12,627,182,698,194,71,12
cell_r8_c13.png,8,13,698,182,734,194,36,12
cell_r8_c14.png,8,14,734,182,767,194,33,12
cell_r8_c15.png,8,15,766,182,822,194,56,12
cell_r8_c16.png,8,16,822,182,887,194,65,12
cell_r8_c17.png,8,17,887,182,919,194,32,12
cell_r8_c18.png,8,18,919,182,985,194,66,12
cell_r8_c19.png,8,19,985,182,1050,194,65,12
cell_r8_c0.png,8,0,1,181,16,193,15,12
cell_r8_c1.png,8,1,16,181,229,193,213,12
cell_r8_c2.png,8,2,229,182,280,193,51,11
cell_r8_c3.png,8,3,280,182,323,193,43,11
cell_r8_c4.png,8,4,323,182,359,193,36,11
cell_r8_c5.png,8,5,359,182,391,193,32,11
cell_r8_c6.png,8,6,391,181,446,193,55,12
cell_r8_c7.png,8,7,445,181,502,193,57,12
cell_r8_c10.png,8,10,538,182,570,194,32,12
cell_r8_c11.png,8,11,570,182,627,194,57,12
cell_r8_c12.png,8,12,627,182,698,194,71,12
cell_r8_c13.png,8,13,698,182,734,194,36,12
cell_r8_c14.png,8,14,734,182,767,194,33,12
cell_r8_c15.png,8,15,766,182,822,194,56,12
cell_r8_c16.png,8,16,822,182,887,194,65,12
cell_r8_c17.png,8,17,887,182,919,194,32,12
cell_r8_c18.png,8,18,919,182,985,194,66,12
cell_r8_c19.png,8,19,985,182,1050,194,65,12
cell_r8_c0.png,8,0,1,181,16,193,15,12
cell_r8_c1.png,8,1,16,181,229,193,213,12
cell_r8_c2.png,8,2,229,182,280,193,51,11
cell_r8_c3.png,8,3,280,182,323,193,43,11
cell_r8_c4.png,8,4,323,182,359,193,36,11
cell_r8_c5.png,8,5,359,182,391,193,32,11
cell_r8_c6.png,8,6,391,181,446,193,55,12
cell_r8_c7.png,8,7,445,181,502,193,57,12
cell_r8_c10.png,8,10,538,182,570,194,32,12
cell_r8_c11.png,8,11,570,182,627,194,57,12
cell_r8_c12.png,8,12,627,182,698,194,71,12
cell_r8_c13.png,8,13,698,182,734,194,36,12
cell_r8_c14.png,8,14,734,182,767,194,33,12
cell_r8_c15.png,8,15,766,182,822,194,56,12
cell_r8_c16.png,8,16,822,182,887,194,65,12
cell_r8_c17.png,8,17,887,182,919,194,32,12
cell_r8_c18.png,8,18,919,182,985,194,66,12
cell_r8_c19.png,8,19,985,182,1050,194,65,12
cell_r8_c0.png,8,0,1,181,16,193,15,12
cell_r8_c1.png,8,1,16,181,229,193,213,12
cell_r8_c2.png,8,2,229,182,280,193,51,11
cell_r8_c3.png,8,3,280,182,323,193,43,11
cell_r8_c4.png,8,4,323,182,359,193,36,11
cell_r8_c5.png,8,5,359,182,391,193,32,11
cell_r8_c6.png,8,6,391,181,446,193,55,12
cell_r8_c7.png,8,7,445,181,502,193,57,12
cell_r8_c10.png,8,10,538,182,570,194,32,12
cell_r8_c11.png,8,11,570,182,627,194,57,12
cell_r8_c12.png,8,12,627,182,698,194,71,12
cell_r8_c13.png,8,13,698,182,734,194,36,12
cell_r8_c14.png,8,14,734,182,767,194,33,12
cell_r8_c15.png,8,15,766,182,822,194,56,12
cell_r8_c16.png,8,16,822,182,887,194,65,12
cell_r8_c17.png,8,17,887,182,919,194,32,12
cell_r8_c18.png,8,18,919,182,985,194,66,12
cell_r8_c19.png,8,19,985,182,1050,194,65,12
cell_r8_c0.png,8,0,1,181,16,193,15,12
cell_r8_c1.png,8,1,16,181,229,193,213,12
cell_r8_c2.png,8,2,229,182,280,193,51,11
cell_r8_c3.png,8,3,280,182,323,193,43,11
cell_r8_c4.png,8,4,323,182,359,193,36,11
cell_r8_c5.png,8,5,359,182,391,193,32,11
cell_r8_c6.png,8,6,391,181,446,193,55,12
cell_r8_c7.png,8,7,445,181,502,193,57,12
cell_r8_c10.png,8,10,538,182,570,194,32,12
cell_r8_c11.png,8,11,570,182,627,194,57,12
cell_r8_c12.png,8,12,627,182,698,194,71,12
cell_r8_c13.png,8,13,698,182,734,194,36,12
cell_r8_c14.png,8,14,734,182,767,194,33,12
cell_r8_c15.png,8,15,766,182,822,194,56,12
cell_r8_c16.png,8,16,822,182,887,194,65,12
cell_r8_c17.png,8,17,887,182,919,194,32,12
cell_r8_c18.png,8,18,919,182,985,194,66,12
cell_r8_c19.png,8,19,985,182,1050,194,65,12
cell_r9_c0.png,9,0,1,193,16,209,15,16
cell_r9_c1.png,9,1,16,193,230,209,214,16
cell_r9_c2.png,9,2,229,193,280,209,51,16
cell_r9_c3.png,9,3,280,193,323,209,43,16
cell_r9_c4.png,9,4,323,193,359,209,36,16
cell_r9_c5.png,9,5,359,193,391,209,32,16
cell_r9_c6.png,9,6,391,193,446,209,55,16
cell_r9_c7.png,9,7,446,193,502,209,56,16
cell_r9_c8.png,9,8,502,193,538,209,36,16
cell_r9_c9.png,9,9,538,193,570,209,32,16
cell_r9_c10.png,9,10,570,194,627,210,57,16
cell_r9_c11.png,9,11,627,193,698,210,71,17
cell_r9_c12.png,9,12,698,193,734,209,36,16
cell_r9_c13.png,9,13,734,194,767,210,33,16
cell_r9_c14.png,9,14,767,193,822,210,55,17
cell_r9_c15.png,9,15,822,193,887,210,65,17
cell_r9_c16.png,9,16,887,194,920,210,33,16
cell_r9_c17.png,9,17,919,194,986,210,67,16
cell_r9_c18.png,9,18,985,194,1051,210,66,16
cell_r9_c0.png,9,0,1,193,16,209,15,16
cell_r9_c1.png,9,1,16,193,230,209,214,16
cell_r9_c2.png,9,2,229,193,280,209,51,16
cell_r9_c3.png,9,3,280,193,323,209,43,16
cell_r9_c4.png,9,4,323,193,359,209,36,16
cell_r9_c5.png,9,5,359,193,391,209,32,16
cell_r9_c6.png,9,6,391,193,446,209,55,16
cell_r9_c7.png,9,7,446,193,502,209,56,16
cell_r9_c8.png,9,8,502,193,538,209,36,16
cell_r9_c9.png,9,9,538,193,570,209,32,16
cell_r9_c10.png,9,10,570,194,627,210,57,16
cell_r9_c11.png,9,11,627,193,698,210,71,17
cell_r9_c12.png,9,12,698,193,734,209,36,16
cell_r9_c13.png,9,13,734,194,767,210,33,16
cell_r9_c14.png,9,14,767,193,822,210,55,17
cell_r9_c15.png,9,15,822,193,887,210,65,17
cell_r9_c16.png,9,16,887,194,920,210,33,16
cell_r9_c17.png,9,17,919,194,986,210,67,16
cell_r9_c18.png,9,18,985,194,1051,210,66,16
cell_r9_c0.png,9,0,1,193,16,209,15,16
cell_r9_c1.png,9,1,16,193,230,209,214,16
cell_r9_c2.png,9,2,229,193,280,209,51,16
cell_r9_c3.png,9,3,280,193,323,209,43,16
cell_r9_c4.png,9,4,323,193,359,209,36,16
cell_r9_c5.png,9,5,359,193,391,209,32,16
cell_r9_c6.png,9,6,391,193,446,209,55,16
cell_r9_c7.png,9,7,446,193,502,209,56,16
cell_r9_c8.png,9,8,502,193,538,209,36,16
cell_r9_c9.png,9,9,538,193,570,209,32,16
cell_r9_c10.png,9,10,570,194,627,210,57,16
cell_r9_c11.png,9,11,627,193,698,210,71,17
cell_r9_c12.png,9,12,698,193,734,209,36,16
cell_r9_c13.png,9,13,734,194,767,210,33,16
cell_r9_c14.png,9,14,767,193,822,210,55,17
cell_r9_c15.png,9,15,822,193,887,210,65,17
cell_r9_c16.png,9,16,887,194,920,210,33,16
cell_r9_c17.png,9,17,919,194,986,210,67,16
cell_r9_c18.png,9,18,985,194,1051,210,66,16
cell_r9_c0.png,9,0,1,193,16,209,15,16
cell_r9_c1.png,9,1,16,193,230,209,214,16
cell_r9_c2.png,9,2,229,193,280,209,51,16
cell_r9_c3.png,9,3,280,193,323,209,43,16
cell_r9_c4.png,9,4,323,193,359,209,36,16
cell_r9_c5.png,9,5,359,193,391,209,32,16
cell_r9_c6.png,9,6,391,193,446,209,55,16
cell_r9_c7.png,9,7,446,193,502,209,56,16
cell_r9_c8.png,9,8,502,193,538,209,36,16
cell_r9_c9.png,9,9,538,193,570,209,32,16
cell_r9_c10.png,9,10,570,194,627,210,57,16
cell_r9_c11.png,9,11,627,193,698,210,71,17
cell_r9_c12.png,9,12,698,193,734,209,36,16
cell_r9_c13.png,9,13,734,194,767,210,33,16
cell_r9_c14.png,9,14,767,193,822,210,55,17
cell_r9_c15.png,9,15,822,193,887,210,65,17
cell_r9_c16.png,9,16,887,194,920,210,33,16
cell_r9_c17.png,9,17,919,194,986,210,67,16
cell_r9_c18.png,9,18,985,194,1051,210,66,16
cell_r9_c0.png,9,0,1,193,16,209,15,16
cell_r9_c1.png,9,1,16,193,230,209,214,16
cell_r9_c2.png,9,2,229,193,280,209,51,16
cell_r9_c3.png,9,3,280,193,323,209,43,16
cell_r9_c4.png,9,4,323,193,359,209,36,16
cell_r9_c5.png,9,5,359,193,391,209,32,16
cell_r9_c6.png,9,6,391,193,446,209,55,16
cell_r9_c7.png,9,7,446,193,502,209,56,16
cell_r9_c8.png,9,8,502,193,538,209,36,16
cell_r9_c9.png,9,9,538,193,570,209,32,16
cell_r9_c10.png,9,10,570,194,627,210,57,16
cell_r9_c11.png,9,11,627,193,698,210,71,17
cell_r9_c12.png,9,12,698,193,734,209,36,16
cell_r9_c13.png,9,13,734,194,767,210,33,16
cell_r9_c14.png,9,14,767,193,822,210,55,17
cell_r9_c15.png,9,15,822,193,887,210,65,17
cell_r9_c16.png,9,16,887,194,920,210,33,16
cell_r9_c17.png,9,17,919,194,986,210,67,16
cell_r9_c18.png,9,18,985,194,1051,210,66,16
cell_r9_c0.png,9,0,1,193,16,209,15,16
cell_r9_c1.png,9,1,16,193,230,209,214,16
cell_r9_c2.png,9,2,229,193,280,209,51,16
cell_r9_c3.png,9,3,280,193,323,209,43,16
cell_r9_c4.png,9,4,323,193,359,209,36,16
cell_r9_c5.png,9,5,359,193,391,209,32,16
cell_r9_c6.png,9,6,391,193,446,209,55,16
cell_r9_c7.png,9,7,446,193,502,209,56,16
cell_r9_c8.png,9,8,502,193,538,209,36,16
cell_r9_c9.png,9,9,538,193,570,209,32,16
cell_r9_c10.png,9,10,570,194,627,210,57,16
cell_r9_c11.png,9,11,627,193,698,210,71,17
cell_r9_c12.png,9,12,698,193,734,209,36,16
cell_r9_c13.png,9,13,734,194,767,210,33,16
cell_r9_c14.png,9,14,767,193,822,210,55,17
cell_r9_c15.png,9,15,822,193,887,210,65,17
cell_r9_c16.png,9,16,887,194,920,210,33,16
cell_r9_c17.png,9,17,919,194,986,210,67,16
cell_r9_c18.png,9,18,985,194,1051,210,66,16
cell_r9_c0.png,9,0,1,193,16,209,15,16
cell_r9_c1.png,9,1,16,193,230,209,214,16
cell_r9_c2.png,9,2,229,193,280,209,51,16
cell_r9_c3.png,9,3,280,193,323,209,43,16
cell_r9_c4.png,9,4,323,193,359,209,36,16
cell_r9_c5.png,9,5,359,193,391,209,32,16
cell_r9_c6.png,9,6,391,193,446,209,55,16
cell_r9_c7.png,9,7,446,193,502,209,56,16
cell_r9_c8.png,9,8,502,193,538,209,36,16
cell_r9_c9.png,9,9,538,193,570,209,32,16
cell_r9_c10.png,9,10,570,194,627,210,57,16
cell_r9_c11.png,9,11,627,193,698,210,71,17
cell_r9_c12.png,9,12,698,193,734,209,36,16
cell_r9_c13.png,9,13,734,194,767,210,33,16
cell_r9_c14.png,9,14,767,193,822,210,55,17
cell_r9_c15.png,9,15,822,193,887,210,65,17
cell_r9_c16.png,9,16,887,194,920,210,33,16
cell_r9_c17.png,9,17,919,194,986,210,67,16
cell_r9_c18.png,9,18,985,194,1051,210,66,16
cell_r9_c0.png,9,0,1,193,16,209,15,16
cell_r9_c1.png,9,1,16,193,230,209,214,16
cell_r9_c2.png,9,2,229,193,280,209,51,16
cell_r9_c3.png,9,3,280,193,323,209,43,16
cell_r9_c4.png,9,4,323,193,359,209,36,16
cell_r9_c5.png,9,5,359,193,391,209,32,16
cell_r9_c6.png,9,6,391,193,446,209,55,16
cell_r9_c7.png,9,7,446,193,502,209,56,16
cell_r9_c8.png,9,8,502,193,538,209,36,16
cell_r9_c9.png,9,9,538,193,570,209,32,16
cell_r9_c10.png,9,10,570,194,627,210,57,16
cell_r9_c11.png,9,11,627,193,698,210,71,17
cell_r9_c12.png,9,12,698,193,734,209,36,16
cell_r9_c13.png,9,13,734,194,767,210,33,16
cell_r9_c14.png,9,14,767,193,822,210,55,17
cell_r9_c15.png,9,15,822,193,887,210,65,17
cell_r9_c16.png,9,16,887,194,920,210,33,16
cell_r9_c17.png,9,17,919,194,986,210,67,16
cell_r9_c18.png,9,18,985,194,1051,210,66,16
cell_r9_c0.png,9,0,1,193,16,209,15,16
cell_r9_c1.png,9,1,16,193,230,209,214,16
cell_r9_c2.png,9,2,229,193,280,209,51,16
cell_r9_c3.png,9,3,280,193,323,209,43,16
cell_r9_c4.png,9,4,323,193,359,209,36,16
cell_r9_c5.png,9,5,359,193,391,209,32,16
cell_r9_c6.png,9,6,391,193,446,209,55,16
cell_r9_c7.png,9,7,446,193,502,209,56,16
cell_r9_c8.png,9,8,502,193,538,209,36,16
cell_r9_c9.png,9,9,538,193,570,209,32,16
cell_r9_c10.png,9,10,570,194,627,210,57,16
cell_r9_c11.png,9,11,627,193,698,210,71,17
cell_r9_c12.png,9,12,698,193,734,209,36,16
cell_r9_c13.png,9,13,734,194,767,210,33,16
cell_r9_c14.png,9,14,767,193,822,210,55,17
cell_r9_c15.png,9,15,822,193,887,210,65,17
cell_r9_c16.png,9,16,887,194,920,210,33,16
cell_r9_c17.png,9,17,919,194,986,210,67,16
cell_r9_c18.png,9,18,985,194,1051,210,66,16
cell_r9_c0.png,9,0,1,193,16,209,15,16
cell_r9_c1.png,9,1,16,193,230,209,214,16
cell_r9_c2.png,9,2,229,193,280,209,51,16
cell_r9_c3.png,9,3,280,193,323,209,43,16
cell_r9_c4.png,9,4,323,193,359,209,36,16
cell_r9_c5.png,9,5,359,193,391,209,32,16
cell_r9_c6.png,9,6,391,193,446,209,55,16
cell_r9_c7.png,9,7,446,193,502,209,56,16
cell_r9_c8.png,9,8,502,193,538,209,36,16
cell_r9_c9.png,9,9,538,193,570,209,32,16
cell_r9_c10.png,9,10,570,194,627,210,57,16
cell_r9_c11.png,9,11,627,193,698,210,71,17
cell_r9_c12.png,9,12,698,193,734,209,36,16
cell_r9_c13.png,9,13,734,194,767,210,33,16
cell_r9_c14.png,9,14,767,193,822,210,55,17
cell_r9_c15.png,9,15,822,193,887,210,65,17
cell_r9_c16.png,9,16,887,194,920,210,33,16
cell_r9_c17.png,9,17,919,194,986,210,67,16
cell_r9_c18.png,9,18,985,194,1051,210,66,16
cell_r9_c0.png,9,0,1,193,16,209,15,16
cell_r9_c1.png,9,1,16,193,230,209,214,16
cell_r9_c2.png,9,2,229,193,280,209,51,16
cell_r9_c3.png,9,3,280,193,323,209,43,16
cell_r9_c4.png,9,4,323,193,359,209,36,16
cell_r9_c5.png,9,5,359,193,391,209,32,16
cell_r9_c6.png,9,6,391,193,446,209,55,16
cell_r9_c7.png,9,7,446,193,502,209,56,16
cell_r9_c8.png,9,8,502,193,538,209,36,16
cell_r9_c9.png,9,9,538,193,570,209,32,16
cell_r9_c10.png,9,10,570,194,627,210,57,16
cell_r9_c11.png,9,11,627,193,698,210,71,17
cell_r9_c12.png,9,12,698,193,734,209,36,16
cell_r9_c13.png,9,13,734,194,767,210,33,16
cell_r9_c14.png,9,14,767,193,822,210,55,17
cell_r9_c15.png,9,15,822,193,887,210,65,17
cell_r9_c16.png,9,16,887,194,920,210,33,16
cell_r9_c17.png,9,17,919,194,986,210,67,16
cell_r9_c18.png,9,18,985,194,1051,210,66,16
cell_r9_c0.png,9,0,1,193,16,209,15,16
cell_r9_c1.png,9,1,16,193,230,209,214,16
cell_r9_c2.png,9,2,229,193,280,209,51,16
cell_r9_c3.png,9,3,280,193,323,209,43,16
cell_r9_c4.png,9,4,323,193,359,209,36,16
cell_r9_c5.png,9,5,359,193,391,209,32,16
cell_r9_c6.png,9,6,391,193,446,209,55,16
cell_r9_c7.png,9,7,446,193,502,209,56,16
cell_r9_c8.png,9,8,502,193,538,209,36,16
cell_r9_c9.png,9,9,538,193,570,209,32,16
cell_r9_c10.png,9,10,570,194,627,210,57,16
cell_r9_c11.png,9,11,627,193,698,210,71,17
cell_r9_c12.png,9,12,698,193,734,209,36,16
cell_r9_c13.png,9,13,734,194,767,210,33,16
cell_r9_c14.png,9,14,767,193,822,210,55,17
cell_r9_c15.png,9,15,822,193,887,210,65,17
cell_r9_c16.png,9,16,887,194,920,210,33,16
cell_r9_c17.png,9,17,919,194,986,210,67,16
cell_r9_c18.png,9,18,985,194,1051,210,66,16
cell_r9_c0.png,9,0,1,193,16,209,15,16
cell_r9_c1.png,9,1,16,193,230,209,214,16
cell_r9_c2.png,9,2,229,193,280,209,51,16
cell_r9_c3.png,9,3,280,193,323,209,43,16
cell_r9_c4.png,9,4,323,193,359,209,36,16
cell_r9_c5.png,9,5,359,193,391,209,32,16
cell_r9_c6.png,9,6,391,193,446,209,55,16
cell_r9_c7.png,9,7,446,193,502,209,56,16
cell_r9_c8.png,9,8,502,193,538,209,36,16
cell_r9_c9.png,9,9,538,193,570,209,32,16
cell_r9_c10.png,9,10,570,194,627,210,57,16
cell_r9_c11.png,9,11,627,193,698,210,71,17
cell_r9_c12.png,9,12,698,193,734,209,36,16
cell_r9_c13.png,9,13,734,194,767,210,33,16
cell_r9_c14.png,9,14,767,193,822,210,55,17
cell_r9_c15.png,9,15,822,193,887,210,65,17
cell_r9_c16.png,9,16,887,194,920,210,33,16
cell_r9_c17.png,9,17,919,194,986,210,67,16
cell_r9_c18.png,9,18,985,194,1051,210,66,16
cell_r9_c0.png,9,0,1,193,16,209,15,16
cell_r9_c1.png,9,1,16,193,230,209,214,16
cell_r9_c2.png,9,2,229,193,280,209,51,16
cell_r9_c3.png,9,3,280,193,323,209,43,16
cell_r9_c4.png,9,4,323,193,359,209,36,16
cell_r9_c5.png,9,5,359,193,391,209,32,16
cell_r9_c6.png,9,6,391,193,446,209,55,16
cell_r9_c7.png,9,7,446,193,502,209,56,16
cell_r9_c8.png,9,8,502,193,538,209,36,16
cell_r9_c9.png,9,9,538,193,570,209,32,16
cell_r9_c10.png,9,10,570,194,627,210,57,16
cell_r9_c11.png,9,11,627,193,698,210,71,17
cell_r9_c12.png,9,12,698,193,734,209,36,16
cell_r9_c13.png,9,13,734,194,767,210,33,16
cell_r9_c14.png,9,14,767,193,822,210,55,17
cell_r9_c15.png,9,15,822,193,887,210,65,17
cell_r9_c16.png,9,16,887,194,920,210,33,16
cell_r9_c17.png,9,17,919,194,986,210,67,16
cell_r9_c18.png,9,18,985,194,1051,210,66,16
cell_r9_c0.png,9,0,1,193,16,209,15,16
cell_r9_c1.png,9,1,16,193,230,209,214,16
cell_r9_c2.png,9,2,229,193,280,209,51,16
cell_r9_c3.png,9,3,280,193,323,209,43,16
cell_r9_c4.png,9,4,323,193,359,209,36,16
cell_r9_c5.png,9,5,359,193,391,209,32,16
cell_r9_c6.png,9,6,391,193,446,209,55,16
cell_r9_c7.png,9,7,446,193,502,209,56,16
cell_r9_c8.png,9,8,502,193,538,209,36,16
cell_r9_c9.png,9,9,538,193,570,209,32,16
cell_r9_c10.png,9,10,570,194,627,210,57,16
cell_r9_c11.png,9,11,627,193,698,210,71,17
cell_r9_c12.png,9,12,698,193,734,209,36,16
cell_r9_c13.png,9,13,734,194,767,210,33,16
cell_r9_c14.png,9,14,767,193,822,210,55,17
cell_r9_c15.png,9,15,822,193,887,210,65,17
cell_r9_c16.png,9,16,887,194,920,210,33,16
cell_r9_c17.png,9,17,919,194,986,210,67,16
cell_r9_c18.png,9,18,985,194,1051,210,66,16
cell_r9_c0.png,9,0,1,193,16,209,15,16
cell_r9_c1.png,9,1,16,193,230,209,214,16
cell_r9_c2.png,9,2,229,193,280,209,51,16
cell_r9_c3.png,9,3,280,193,323,209,43,16
cell_r9_c4.png,9,4,323,193,359,209,36,16
cell_r9_c5.png,9,5,359,193,391,209,32,16
cell_r9_c6.png,9,6,391,193,446,209,55,16
cell_r9_c7.png,9,7,446,193,502,209,56,16
cell_r9_c8.png,9,8,502,193,538,209,36,16
cell_r9_c9.png,9,9,538,193,570,209,32,16
cell_r9_c10.png,9,10,570,194,627,210,57,16
cell_r9_c11.png,9,11,627,193,698,210,71,17
cell_r9_c12.png,9,12,698,193,734,209,36,16
cell_r9_c13.png,9,13,734,194,767,210,33,16
cell_r9_c14.png,9,14,767,193,822,210,55,17
cell_r9_c15.png,9,15,822,193,887,210,65,17
cell_r9_c16.png,9,16,887,194,920,210,33,16
cell_r9_c17.png,9,17,919,194,986,210,67,16
cell_r9_c18.png,9,18,985,194,1051,210,66,16
cell_r9_c0.png,9,0,1,193,16,209,15,16
cell_r9_c1.png,9,1,16,193,230,209,214,16
cell_r9_c2.png,9,2,229,193,280,209,51,16
cell_r9_c3.png,9,3,280,193,323,209,43,16
cell_r9_c4.png,9,4,323,193,359,209,36,16
cell_r9_c5.png,9,5,359,193,391,209,32,16
cell_r9_c6.png,9,6,391,193,446,209,55,16
cell_r9_c7.png,9,7,446,193,502,209,56,16
cell_r9_c8.png,9,8,502,193,538,209,36,16
cell_r9_c9.png,9,9,538,193,570,209,32,16
cell_r9_c10.png,9,10,570,194,627,210,57,16
cell_r9_c11.png,9,11,627,193,698,210,71,17
cell_r9_c12.png,9,12,698,193,734,209,36,16
cell_r9_c13.png,9,13,734,194,767,210,33,16
cell_r9_c14.png,9,14,767,193,822,210,55,17
cell_r9_c15.png,9,15,822,193,887,210,65,17
cell_r9_c16.png,9,16,887,194,920,210,33,16
cell_r9_c17.png,9,17,919,194,986,210,67,16
cell_r9_c18.png,9,18,985,194,1051,210,66,16
cell_r9_c0.png,9,0,1,193,16,209,15,16
cell_r9_c1.png,9,1,16,193,230,209,214,16
cell_r9_c2.png,9,2,229,193,280,209,51,16
cell_r9_c3.png,9,3,280,193,323,209,43,16
cell_r9_c4.png,9,4,323,193,359,209,36,16
cell_r9_c5.png,9,5,359,193,391,209,32,16
cell_r9_c6.png,9,6,391,193,446,209,55,16
cell_r9_c7.png,9,7,446,193,502,209,56,16
cell_r9_c8.png,9,8,502,193,538,209,36,16
cell_r9_c9.png,9,9,538,193,570,209,32,16
cell_r9_c10.png,9,10,570,194,627,210,57,16
cell_r9_c11.png,9,11,627,193,698,210,71,17
cell_r9_c12.png,9,12,698,193,734,209,36,16
cell_r9_c13.png,9,13,734,194,767,210,33,16
cell_r9_c14.png,9,14,767,193,822,210,55,17
cell_r9_c15.png,9,15,822,193,887,210,65,17
cell_r9_c16.png,9,16,887,194,920,210,33,16
cell_r9_c17.png,9,17,919,194,986,210,67,16
cell_r9_c18.png,9,18,985,194,1051,210,66,16
cell_r9_c0.png,9,0,1,193,16,209,15,16
cell_r9_c1.png,9,1,16,193,230,209,214,16
cell_r9_c2.png,9,2,229,193,280,209,51,16
cell_r9_c3.png,9,3,280,193,323,209,43,16
cell_r9_c4.png,9,4,323,193,359,209,36,16
cell_r9_c5.png,9,5,359,193,391,209,32,16
cell_r9_c6.png,9,6,391,193,446,209,55,16
cell_r9_c7.png,9,7,446,193,502,209,56,16
cell_r9_c8.png,9,8,502,193,538,209,36,16
cell_r9_c9.png,9,9,538,193,570,209,32,16
cell_r9_c10.png,9,10,570,194,627,210,57,16
cell_r9_c11.png,9,11,627,193,698,210,71,17
cell_r9_c12.png,9,12,698,193,734,209,36,16
cell_r9_c13.png,9,13,734,194,767,210,33,16
cell_r9_c14.png,9,14,767,193,822,210,55,17
cell_r9_c15.png,9,15,822,193,887,210,65,17
cell_r9_c16.png,9,16,887,194,920,210,33,16
cell_r9_c17.png,9,17,919,194,986,210,67,16
cell_r9_c18.png,9,18,985,194,1051,210,66,16
cell_r10_c0.png,10,0,1,209,16,220,15,11
cell_r10_c1.png,10,1,16,209,230,220,214,11
cell_r10_c2.png,10,2,229,209,280,220,51,11
cell_r10_c3.png,10,3,280,209,323,220,43,11
cell_r10_c4.png,10,4,323,209,359,220,36,11
cell_r10_c5.png,10,5,359,209,391,220,32,11
cell_r10_c6.png,10,6,390,209,446,221,56,12
cell_r10_c7.png,10,7,446,209,502,221,56,12
cell_r10_c8.png,10,8,502,209,538,221,36,12
cell_r10_c9.png,10,9,538,209,571,221,33,12
cell_r10_c10.png,10,10,570,209,627,221,57,12
cell_r10_c11.png,10,11,627,209,698,221,71,12
cell_r10_c12.png,10,12,698,209,734,221,36,12
cell_r10_c13.png,10,13,734,209,767,221,33,12
cell_r10_c14.png,10,14,767,210,822,221,55,11
cell_r10_c15.png,10,15,822,210,887,221,65,11
cell_r10_c16.png,10,16,887,210,920,221,33,11
cell_r10_c17.png,10,17,920,210,986,221,66,11
cell_r10_c18.png,10,18,986,209,1051,222,65,13
cell_r10_c0.png,10,0,1,209,16,220,15,11
cell_r10_c1.png,10,1,16,209,230,220,214,11
cell_r10_c2.png,10,2,229,209,280,220,51,11
cell_r10_c3.png,10,3,280,209,323,220,43,11
cell_r10_c4.png,10,4,323,209,359,220,36,11
cell_r10_c5.png,10,5,359,209,391,220,32,11
cell_r10_c6.png,10,6,390,209,446,221,56,12
cell_r10_c7.png,10,7,446,209,502,221,56,12
cell_r10_c8.png,10,8,502,209,538,221,36,12
cell_r10_c9.png,10,9,538,209,571,221,33,12
cell_r10_c10.png,10,10,570,209,627,221,57,12
cell_r10_c11.png,10,11,627,209,698,221,71,12
cell_r10_c12.png,10,12,698,209,734,221,36,12
cell_r10_c13.png,10,13,734,209,767,221,33,12
cell_r10_c14.png,10,14,767,210,822,221,55,11
cell_r10_c15.png,10,15,822,210,887,221,65,11
cell_r10_c16.png,10,16,887,210,920,221,33,11
cell_r10_c17.png,10,17,920,210,986,221,66,11
cell_r10_c18.png,10,18,986,209,1051,222,65,13
cell_r10_c0.png,10,0,1,209,16,220,15,11
cell_r10_c1.png,10,1,16,209,230,220,214,11
cell_r10_c2.png,10,2,229,209,280,220,51,11
cell_r10_c3.png,10,3,280,209,323,220,43,11
cell_r10_c4.png,10,4,323,209,359,220,36,11
cell_r10_c5.png,10,5,359,209,391,220,32,11
cell_r10_c6.png,10,6,390,209,446,221,56,12
cell_r10_c7.png,10,7,446,209,502,221,56,12
cell_r10_c8.png,10,8,502,209,538,221,36,12
cell_r10_c9.png,10,9,538,209,571,221,33,12
cell_r10_c10.png,10,10,570,209,627,221,57,12
cell_r10_c11.png,10,11,627,209,698,221,71,12
cell_r10_c12.png,10,12,698,209,734,221,36,12
cell_r10_c13.png,10,13,734,209,767,221,33,12
cell_r10_c14.png,10,14,767,210,822,221,55,11
cell_r10_c15.png,10,15,822,210,887,221,65,11
cell_r10_c16.png,10,16,887,210,920,221,33,11
cell_r10_c17.png,10,17,920,210,986,221,66,11
cell_r10_c18.png,10,18,986,209,1051,222,65,13
cell_r10_c0.png,10,0,1,209,16,220,15,11
cell_r10_c1.png,10,1,16,209,230,220,214,11
cell_r10_c2.png,10,2,229,209,280,220,51,11
cell_r10_c3.png,10,3,280,209,323,220,43,11
cell_r10_c4.png,10,4,323,209,359,220,36,11
cell_r10_c5.png,10,5,359,209,391,220,32,11
cell_r10_c6.png,10,6,390,209,446,221,56,12
cell_r10_c7.png,10,7,446,209,502,221,56,12
cell_r10_c8.png,10,8,502,209,538,221,36,12
cell_r10_c9.png,10,9,538,209,571,221,33,12
cell_r10_c10.png,10,10,570,209,627,221,57,12
cell_r10_c11.png,10,11,627,209,698,221,71,12
cell_r10_c12.png,10,12,698,209,734,221,36,12
cell_r10_c13.png,10,13,734,209,767,221,33,12
cell_r10_c14.png,10,14,767,210,822,221,55,11
cell_r10_c15.png,10,15,822,210,887,221,65,11
cell_r10_c16.png,10,16,887,210,920,221,33,11
cell_r10_c17.png,10,17,920,210,986,221,66,11
cell_r10_c18.png,10,18,986,209,1051,222,65,13
cell_r10_c0.png,10,0,1,209,16,220,15,11
cell_r10_c1.png,10,1,16,209,230,220,214,11
cell_r10_c2.png,10,2,229,209,280,220,51,11
cell_r10_c3.png,10,3,280,209,323,220,43,11
cell_r10_c4.png,10,4,323,209,359,220,36,11
cell_r10_c5.png,10,5,359,209,391,220,32,11
cell_r10_c6.png,10,6,390,209,446,221,56,12
cell_r10_c7.png,10,7,446,209,502,221,56,12
cell_r10_c8.png,10,8,502,209,538,221,36,12
cell_r10_c9.png,10,9,538,209,571,221,33,12
cell_r10_c10.png,10,10,570,209,627,221,57,12
cell_r10_c11.png,10,11,627,209,698,221,71,12
cell_r10_c12.png,10,12,698,209,734,221,36,12
cell_r10_c13.png,10,13,734,209,767,221,33,12
cell_r10_c14.png,10,14,767,210,822,221,55,11
cell_r10_c15.png,10,15,822,210,887,221,65,11
cell_r10_c16.png,10,16,887,210,920,221,33,11
cell_r10_c17.png,10,17,920,210,986,221,66,11
cell_r10_c18.png,10,18,986,209,1051,222,65,13
cell_r10_c0.png,10,0,1,209,16,220,15,11
cell_r10_c1.png,10,1,16,209,230,220,214,11
cell_r10_c2.png,10,2,229,209,280,220,51,11
cell_r10_c3.png,10,3,280,209,323,220,43,11
cell_r10_c4.png,10,4,323,209,359,220,36,11
cell_r10_c5.png,10,5,359,209,391,220,32,11
cell_r10_c6.png,10,6,390,209,446,221,56,12
cell_r10_c7.png,10,7,446,209,502,221,56,12
cell_r10_c8.png,10,8,502,209,538,221,36,12
cell_r10_c9.png,10,9,538,209,571,221,33,12
cell_r10_c10.png,10,10,570,209,627,221,57,12
cell_r10_c11.png,10,11,627,209,698,221,71,12
cell_r10_c12.png,10,12,698,209,734,221,36,12
cell_r10_c13.png,10,13,734,209,767,221,33,12
cell_r10_c14.png,10,14,767,210,822,221,55,11
cell_r10_c15.png,10,15,822,210,887,221,65,11
cell_r10_c16.png,10,16,887,210,920,221,33,11
cell_r10_c17.png,10,17,920,210,986,221,66,11
cell_r10_c18.png,10,18,986,209,1051,222,65,13
cell_r10_c0.png,10,0,1,209,16,220,15,11
cell_r10_c1.png,10,1,16,209,230,220,214,11
cell_r10_c2.png,10,2,229,209,280,220,51,11
cell_r10_c3.png,10,3,280,209,323,220,43,11
cell_r10_c4.png,10,4,323,209,359,220,36,11
cell_r10_c5.png,10,5,359,209,391,220,32,11
cell_r10_c6.png,10,6,390,209,446,221,56,12
cell_r10_c7.png,10,7,446,209,502,221,56,12
cell_r10_c8.png,10,8,502,209,538,221,36,12
cell_r10_c9.png,10,9,538,209,571,221,33,12
cell_r10_c10.png,10,10,570,209,627,221,57,12
cell_r10_c11.png,10,11,627,209,698,221,71,12
cell_r10_c12.png,10,12,698,209,734,221,36,12
cell_r10_c13.png,10,13,734,209,767,221,33,12
cell_r10_c14.png,10,14,767,210,822,221,55,11
cell_r10_c15.png,10,15,822,210,887,221,65,11
cell_r10_c16.png,10,16,887,210,920,221,33,11
cell_r10_c17.png,10,17,920,210,986,221,66,11
cell_r10_c18.png,10,18,986,209,1051,222,65,13
cell_r10_c0.png,10,0,1,209,16,220,15,11
cell_r10_c1.png,10,1,16,209,230,220,214,11
cell_r10_c2.png,10,2,229,209,280,220,51,11
cell_r10_c3.png,10,3,280,209,323,220,43,11
cell_r10_c4.png,10,4,323,209,359,220,36,11
cell_r10_c5.png,10,5,359,209,391,220,32,11
cell_r10_c6.png,10,6,390,209,446,221,56,12
cell_r10_c7.png,10,7,446,209,502,221,56,12
cell_r10_c8.png,10,8,502,209,538,221,36,12
cell_r10_c9.png,10,9,538,209,571,221,33,12
cell_r10_c10.png,10,10,570,209,627,221,57,12
cell_r10_c11.png,10,11,627,209,698,221,71,12
cell_r10_c12.png,10,12,698,209,734,221,36,12
cell_r10_c13.png,10,13,734,209,767,221,33,12
cell_r10_c14.png,10,14,767,210,822,221,55,11
cell_r10_c15.png,10,15,822,210,887,221,65,11
cell_r10_c16.png,10,16,887,210,920,221,33,11
cell_r10_c17.png,10,17,920,210,986,221,66,11
cell_r10_c18.png,10,18,986,209,1051,222,65,13
cell_r10_c0.png,10,0,1,209,16,220,15,11
cell_r10_c1.png,10,1,16,209,230,220,214,11
cell_r10_c2.png,10,2,229,209,280,220,51,11
cell_r10_c3.png,10,3,280,209,323,220,43,11
cell_r10_c4.png,10,4,323,209,359,220,36,11
cell_r10_c5.png,10,5,359,209,391,220,32,11
cell_r10_c6.png,10,6,390,209,446,221,56,12
cell_r10_c7.png,10,7,446,209,502,221,56,12
cell_r10_c8.png,10,8,502,209,538,221,36,12
cell_r10_c9.png,10,9,538,209,571,221,33,12
cell_r10_c10.png,10,10,570,209,627,221,57,12
cell_r10_c11.png,10,11,627,209,698,221,71,12
cell_r10_c12.png,10,12,698,209,734,221,36,12
cell_r10_c13.png,10,13,734,209,767,221,33,12
cell_r10_c14.png,10,14,767,210,822,221,55,11
cell_r10_c15.png,10,15,822,210,887,221,65,11
cell_r10_c16.png,10,16,887,210,920,221,33,11
cell_r10_c17.png,10,17,920,210,986,221,66,11
cell_r10_c18.png,10,18,986,209,1051,222,65,13
cell_r10_c0.png,10,0,1,209,16,220,15,11
cell_r10_c1.png,10,1,16,209,230,220,214,11
cell_r10_c2.png,10,2,229,209,280,220,51,11
cell_r10_c3.png,10,3,280,209,323,220,43,11
cell_r10_c4.png,10,4,323,209,359,220,36,11
cell_r10_c5.png,10,5,359,209,391,220,32,11
cell_r10_c6.png,10,6,390,209,446,221,56,12
cell_r10_c7.png,10,7,446,209,502,221,56,12
cell_r10_c8.png,10,8,502,209,538,221,36,12
cell_r10_c9.png,10,9,538,209,571,221,33,12
cell_r10_c10.png,10,10,570,209,627,221,57,12
cell_r10_c11.png,10,11,627,209,698,221,71,12
cell_r10_c12.png,10,12,698,209,734,221,36,12
cell_r10_c13.png,10,13,734,209,767,221,33,12
cell_r10_c14.png,10,14,767,210,822,221,55,11
cell_r10_c15.png,10,15,822,210,887,221,65,11
cell_r10_c16.png,10,16,887,210,920,221,33,11
cell_r10_c17.png,10,17,920,210,986,221,66,11
cell_r10_c18.png,10,18,986,209,1051,222,65,13
cell_r10_c0.png,10,0,1,209,16,220,15,11
cell_r10_c1.png,10,1,16,209,230,220,214,11
cell_r10_c2.png,10,2,229,209,280,220,51,11
cell_r10_c3.png,10,3,280,209,323,220,43,11
cell_r10_c4.png,10,4,323,209,359,220,36,11
cell_r10_c5.png,10,5,359,209,391,220,32,11
cell_r10_c6.png,10,6,390,209,446,221,56,12
cell_r10_c7.png,10,7,446,209,502,221,56,12
cell_r10_c8.png,10,8,502,209,538,221,36,12
cell_r10_c9.png,10,9,538,209,571,221,33,12
cell_r10_c10.png,10,10,570,209,627,221,57,12
cell_r10_c11.png,10,11,627,209,698,221,71,12
cell_r10_c12.png,10,12,698,209,734,221,36,12
cell_r10_c13.png,10,13,734,209,767,221,33,12
cell_r10_c14.png,10,14,767,210,822,221,55,11
cell_r10_c15.png,10,15,822,210,887,221,65,11
cell_r10_c16.png,10,16,887,210,920,221,33,11
cell_r10_c17.png,10,17,920,210,986,221,66,11
cell_r10_c18.png,10,18,986,209,1051,222,65,13
cell_r10_c0.png,10,0,1,209,16,220,15,11
cell_r10_c1.png,10,1,16,209,230,220,214,11
cell_r10_c2.png,10,2,229,209,280,220,51,11
cell_r10_c3.png,10,3,280,209,323,220,43,11
cell_r10_c4.png,10,4,323,209,359,220,36,11
cell_r10_c5.png,10,5,359,209,391,220,32,11
cell_r10_c6.png,10,6,390,209,446,221,56,12
cell_r10_c7.png,10,7,446,209,502,221,56,12
cell_r10_c8.png,10,8,502,209,538,221,36,12
cell_r10_c9.png,10,9,538,209,571,221,33,12
cell_r10_c10.png,10,10,570,209,627,221,57,12
cell_r10_c11.png,10,11,627,209,698,221,71,12
cell_r10_c12.png,10,12,698,209,734,221,36,12
cell_r10_c13.png,10,13,734,209,767,221,33,12
cell_r10_c14.png,10,14,767,210,822,221,55,11
cell_r10_c15.png,10,15,822,210,887,221,65,11
cell_r10_c16.png,10,16,887,210,920,221,33,11
cell_r10_c17.png,10,17,920,210,986,221,66,11
cell_r10_c18.png,10,18,986,209,1051,222,65,13
cell_r10_c0.png,10,0,1,209,16,220,15,11
cell_r10_c1.png,10,1,16,209,230,220,214,11
cell_r10_c2.png,10,2,229,209,280,220,51,11
cell_r10_c3.png,10,3,280,209,323,220,43,11
cell_r10_c4.png,10,4,323,209,359,220,36,11
cell_r10_c5.png,10,5,359,209,391,220,32,11
cell_r10_c6.png,10,6,390,209,446,221,56,12
cell_r10_c7.png,10,7,446,209,502,221,56,12
cell_r10_c8.png,10,8,502,209,538,221,36,12
cell_r10_c9.png,10,9,538,209,571,221,33,12
cell_r10_c10.png,10,10,570,209,627,221,57,12
cell_r10_c11.png,10,11,627,209,698,221,71,12
cell_r10_c12.png,10,12,698,209,734,221,36,12
cell_r10_c13.png,10,13,734,209,767,221,33,12
cell_r10_c14.png,10,14,767,210,822,221,55,11
cell_r10_c15.png,10,15,822,210,887,221,65,11
cell_r10_c16.png,10,16,887,210,920,221,33,11
cell_r10_c17.png,10,17,920,210,986,221,66,11
cell_r10_c18.png,10,18,986,209,1051,222,65,13
cell_r10_c0.png,10,0,1,209,16,220,15,11
cell_r10_c1.png,10,1,16,209,230,220,214,11
cell_r10_c2.png,10,2,229,209,280,220,51,11
cell_r10_c3.png,10,3,280,209,323,220,43,11
cell_r10_c4.png,10,4,323,209,359,220,36,11
cell_r10_c5.png,10,5,359,209,391,220,32,11
cell_r10_c6.png,10,6,390,209,446,221,56,12
cell_r10_c7.png,10,7,446,209,502,221,56,12
cell_r10_c8.png,10,8,502,209,538,221,36,12
cell_r10_c9.png,10,9,538,209,571,221,33,12
cell_r10_c10.png,10,10,570,209,627,221,57,12
cell_r10_c11.png,10,11,627,209,698,221,71,12
cell_r10_c12.png,10,12,698,209,734,221,36,12
cell_r10_c13.png,10,13,734,209,767,221,33,12
cell_r10_c14.png,10,14,767,210,822,221,55,11
cell_r10_c15.png,10,15,822,210,887,221,65,11
cell_r10_c16.png,10,16,887,210,920,221,33,11
cell_r10_c17.png,10,17,920,210,986,221,66,11
cell_r10_c18.png,10,18,986,209,1051,222,65,13
cell_r10_c0.png,10,0,1,209,16,220,15,11
cell_r10_c1.png,10,1,16,209,230,220,214,11
cell_r10_c2.png,10,2,229,209,280,220,51,11
cell_r10_c3.png,10,3,280,209,323,220,43,11
cell_r10_c4.png,10,4,323,209,359,220,36,11
cell_r10_c5.png,10,5,359,209,391,220,32,11
cell_r10_c6.png,10,6,390,209,446,221,56,12
cell_r10_c7.png,10,7,446,209,502,221,56,12
cell_r10_c8.png,10,8,502,209,538,221,36,12
cell_r10_c9.png,10,9,538,209,571,221,33,12
cell_r10_c10.png,10,10,570,209,627,221,57,12
cell_r10_c11.png,10,11,627,209,698,221,71,12
cell_r10_c12.png,10,12,698,209,734,221,36,12
cell_r10_c13.png,10,13,734,209,767,221,33,12
cell_r10_c14.png,10,14,767,210,822,221,55,11
cell_r10_c15.png,10,15,822,210,887,221,65,11
cell_r10_c16.png,10,16,887,210,920,221,33,11
cell_r10_c17.png,10,17,920,210,986,221,66,11
cell_r10_c18.png,10,18,986,209,1051,222,65,13
cell_r10_c0.png,10,0,1,209,16,220,15,11
cell_r10_c1.png,10,1,16,209,230,220,214,11
cell_r10_c2.png,10,2,229,209,280,220,51,11
cell_r10_c3.png,10,3,280,209,323,220,43,11
cell_r10_c4.png,10,4,323,209,359,220,36,11
cell_r10_c5.png,10,5,359,209,391,220,32,11
cell_r10_c6.png,10,6,390,209,446,221,56,12
cell_r10_c7.png,10,7,446,209,502,221,56,12
cell_r10_c8.png,10,8,502,209,538,221,36,12
cell_r10_c9.png,10,9,538,209,571,221,33,12
cell_r10_c10.png,10,10,570,209,627,221,57,12
cell_r10_c11.png,10,11,627,209,698,221,71,12
cell_r10_c12.png,10,12,698,209,734,221,36,12
cell_r10_c13.png,10,13,734,209,767,221,33,12
cell_r10_c14.png,10,14,767,210,822,221,55,11
cell_r10_c15.png,10,15,822,210,887,221,65,11
cell_r10_c16.png,10,16,887,210,920,221,33,11
cell_r10_c17.png,10,17,920,210,986,221,66,11
cell_r10_c18.png,10,18,986,209,1051,222,65,13
cell_r10_c0.png,10,0,1,209,16,220,15,11
cell_r10_c1.png,10,1,16,209,230,220,214,11
cell_r10_c2.png,10,2,229,209,280,220,51,11
cell_r10_c3.png,10,3,280,209,323,220,43,11
cell_r10_c4.png,10,4,323,209,359,220,36,11
cell_r10_c5.png,10,5,359,209,391,220,32,11
cell_r10_c6.png,10,6,390,209,446,221,56,12
cell_r10_c7.png,10,7,446,209,502,221,56,12
cell_r10_c8.png,10,8,502,209,538,221,36,12
cell_r10_c9.png,10,9,538,209,571,221,33,12
cell_r10_c10.png,10,10,570,209,627,221,57,12
cell_r10_c11.png,10,11,627,209,698,221,71,12
cell_r10_c12.png,10,12,698,209,734,221,36,12
cell_r10_c13.png,10,13,734,209,767,221,33,12
cell_r10_c14.png,10,14,767,210,822,221,55,11
cell_r10_c15.png,10,15,822,210,887,221,65,11
cell_r10_c16.png,10,16,887,210,920,221,33,11
cell_r10_c17.png,10,17,920,210,986,221,66,11
cell_r10_c18.png,10,18,986,209,1051,222,65,13
cell_r10_c0.png,10,0,1,209,16,220,15,11
cell_r10_c1.png,10,1,16,209,230,220,214,11
cell_r10_c2.png,10,2,229,209,280,220,51,11
cell_r10_c3.png,10,3,280,209,323,220,43,11
cell_r10_c4.png,10,4,323,209,359,220,36,11
cell_r10_c5.png,10,5,359,209,391,220,32,11
cell_r10_c6.png,10,6,390,209,446,221,56,12
cell_r10_c7.png,10,7,446,209,502,221,56,12
cell_r10_c8.png,10,8,502,209,538,221,36,12
cell_r10_c9.png,10,9,538,209,571,221,33,12
cell_r10_c10.png,10,10,570,209,627,221,57,12
cell_r10_c11.png,10,11,627,209,698,221,71,12
cell_r10_c12.png,10,12,698,209,734,221,36,12
cell_r10_c13.png,10,13,734,209,767,221,33,12
cell_r10_c14.png,10,14,767,210,822,221,55,11
cell_r10_c15.png,10,15,822,210,887,221,65,11
cell_r10_c16.png,10,16,887,210,920,221,33,11
cell_r10_c17.png,10,17,920,210,986,221,66,11
cell_r10_c18.png,10,18,986,209,1051,222,65,13
cell_r10_c0.png,10,0,1,209,16,220,15,11
cell_r10_c1.png,10,1,16,209,230,220,214,11
cell_r10_c2.png,10,2,229,209,280,220,51,11
cell_r10_c3.png,10,3,280,209,323,220,43,11
cell_r10_c4.png,10,4,323,209,359,220,36,11
cell_r10_c5.png,10,5,359,209,391,220,32,11
cell_r10_c6.png,10,6,390,209,446,221,56,12
cell_r10_c7.png,10,7,446,209,502,221,56,12
cell_r10_c8.png,10,8,502,209,538,221,36,12
cell_r10_c9.png,10,9,538,209,571,221,33,12
cell_r10_c10.png,10,10,570,209,627,221,57,12
cell_r10_c11.png,10,11,627,209,698,221,71,12
cell_r10_c12.png,10,12,698,209,734,221,36,12
cell_r10_c13.png,10,13,734,209,767,221,33,12
cell_r10_c14.png,10,14,767,210,822,221,55,11
cell_r10_c15.png,10,15,822,210,887,221,65,11
cell_r10_c16.png,10,16,887,210,920,221,33,11
cell_r10_c17.png,10,17,920,210,986,221,66,11
cell_r10_c18.png,10,18,986,209,1051,222,65,13
cell_r11_c0.png,11,0,1,220,16,231,15,11
cell_r11_c1.png,11,1,16,220,229,232,213,12
cell_r11_c2.png,11,2,229,220,280,232,51,12
cell_r11_c3.png,11,3,280,220,323,232,43,12
cell_r11_c4.png,11,4,323,220,359,232,36,12
cell_r11_c5.png,11,5,359,220,390,232,31,12
cell_r11_c6.png,11,6,390,220,446,232,56,12
cell_r11_c7.png,11,7,446,220,502,232,56,12
cell_r11_c8.png,11,8,502,220,538,232,36,12
cell_r11_c9.png,11,9,538,221,571,232,33,11
cell_r11_c10.png,11,10,571,221,627,232,56,11
cell_r11_c11.png,11,11,627,221,698,232,71,11
cell_r11_c12.png,11,12,698,221,734,232,36,11
cell_r11_c13.png,11,13,734,221,767,232,33,11
cell_r11_c14.png,11,14,767,221,822,233,55,12
cell_r11_c15.png,11,15,822,221,887,233,65,12
cell_r11_c16.png,11,16,887,221,920,232,33,11
cell_r11_c17.png,11,17,920,221,986,233,66,12
cell_r11_c18.png,11,18,986,221,1051,233,65,12
cell_r11_c0.png,11,0,1,220,16,231,15,11
cell_r11_c1.png,11,1,16,220,229,232,213,12
cell_r11_c2.png,11,2,229,220,280,232,51,12
cell_r11_c3.png,11,3,280,220,323,232,43,12
cell_r11_c4.png,11,4,323,220,359,232,36,12
cell_r11_c5.png,11,5,359,220,390,232,31,12
cell_r11_c6.png,11,6,390,220,446,232,56,12
cell_r11_c7.png,11,7,446,220,502,232,56,12
cell_r11_c8.png,11,8,502,220,538,232,36,12
cell_r11_c9.png,11,9,538,221,571,232,33,11
cell_r11_c10.png,11,10,571,221,627,232,56,11
cell_r11_c11.png,11,11,627,221,698,232,71,11
cell_r11_c12.png,11,12,698,221,734,232,36,11
cell_r11_c13.png,11,13,734,221,767,232,33,11
cell_r11_c14.png,11,14,767,221,822,233,55,12
cell_r11_c15.png,11,15,822,221,887,233,65,12
cell_r11_c16.png,11,16,887,221,920,232,33,11
cell_r11_c17.png,11,17,920,221,986,233,66,12
cell_r11_c18.png,11,18,986,221,1051,233,65,12
cell_r11_c0.png,11,0,1,220,16,231,15,11
cell_r11_c1.png,11,1,16,220,229,232,213,12
cell_r11_c2.png,11,2,229,220,280,232,51,12
cell_r11_c3.png,11,3,280,220,323,232,43,12
cell_r11_c4.png,11,4,323,220,359,232,36,12
cell_r11_c5.png,11,5,359,220,390,232,31,12
cell_r11_c6.png,11,6,390,220,446,232,56,12
cell_r11_c7.png,11,7,446,220,502,232,56,12
cell_r11_c8.png,11,8,502,220,538,232,36,12
cell_r11_c9.png,11,9,538,221,571,232,33,11
cell_r11_c10.png,11,10,571,221,627,232,56,11
cell_r11_c11.png,11,11,627,221,698,232,71,11
cell_r11_c12.png,11,12,698,221,734,232,36,11
cell_r11_c13.png,11,13,734,221,767,232,33,11
cell_r11_c14.png,11,14,767,221,822,233,55,12
cell_r11_c15.png,11,15,822,221,887,233,65,12
cell_r11_c16.png,11,16,887,221,920,232,33,11
cell_r11_c17.png,11,17,920,221,986,233,66,12
cell_r11_c18.png,11,18,986,221,1051,233,65,12
cell_r11_c0.png,11,0,1,220,16,231,15,11
cell_r11_c1.png,11,1,16,220,229,232,213,12
cell_r11_c2.png,11,2,229,220,280,232,51,12
cell_r11_c3.png,11,3,280,220,323,232,43,12
cell_r11_c4.png,11,4,323,220,359,232,36,12
cell_r11_c5.png,11,5,359,220,390,232,31,12
cell_r11_c6.png,11,6,390,220,446,232,56,12
cell_r11_c7.png,11,7,446,220,502,232,56,12
cell_r11_c8.png,11,8,502,220,538,232,36,12
cell_r11_c9.png,11,9,538,221,571,232,33,11
cell_r11_c10.png,11,10,571,221,627,232,56,11
cell_r11_c11.png,11,11,627,221,698,232,71,11
cell_r11_c12.png,11,12,698,221,734,232,36,11
cell_r11_c13.png,11,13,734,221,767,232,33,11
cell_r11_c14.png,11,14,767,221,822,233,55,12
cell_r11_c15.png,11,15,822,221,887,233,65,12
cell_r11_c16.png,11,16,887,221,920,232,33,11
cell_r11_c17.png,11,17,920,221,986,233,66,12
cell_r11_c18.png,11,18,986,221,1051,233,65,12
cell_r11_c0.png,11,0,1,220,16,231,15,11
cell_r11_c1.png,11,1,16,220,229,232,213,12
cell_r11_c2.png,11,2,229,220,280,232,51,12
cell_r11_c3.png,11,3,280,220,323,232,43,12
cell_r11_c4.png,11,4,323,220,359,232,36,12
cell_r11_c5.png,11,5,359,220,390,232,31,12
cell_r11_c6.png,11,6,390,220,446,232,56,12
cell_r11_c7.png,11,7,446,220,502,232,56,12
cell_r11_c8.png,11,8,502,220,538,232,36,12
cell_r11_c9.png,11,9,538,221,571,232,33,11
cell_r11_c10.png,11,10,571,221,627,232,56,11
cell_r11_c11.png,11,11,627,221,698,232,71,11
cell_r11_c12.png,11,12,698,221,734,232,36,11
cell_r11_c13.png,11,13,734,221,767,232,33,11
cell_r11_c14.png,11,14,767,221,822,233,55,12
cell_r11_c15.png,11,15,822,221,887,233,65,12
cell_r11_c16.png,11,16,887,221,920,232,33,11
cell_r11_c17.png,11,17,920,221,986,233,66,12
cell_r11_c18.png,11,18,986,221,1051,233,65,12
cell_r11_c0.png,11,0,1,220,16,231,15,11
cell_r11_c1.png,11,1,16,220,229,232,213,12
cell_r11_c2.png,11,2,229,220,280,232,51,12
cell_r11_c3.png,11,3,280,220,323,232,43,12
cell_r11_c4.png,11,4,323,220,359,232,36,12
cell_r11_c5.png,11,5,359,220,390,232,31,12
cell_r11_c6.png,11,6,390,220,446,232,56,12
cell_r11_c7.png,11,7,446,220,502,232,56,12
cell_r11_c8.png,11,8,502,220,538,232,36,12
cell_r11_c9.png,11,9,538,221,571,232,33,11
cell_r11_c10.png,11,10,571,221,627,232,56,11
cell_r11_c11.png,11,11,627,221,698,232,71,11
cell_r11_c12.png,11,12,698,221,734,232,36,11
cell_r11_c13.png,11,13,734,221,767,232,33,11
cell_r11_c14.png,11,14,767,221,822,233,55,12
cell_r11_c15.png,11,15,822,221,887,233,65,12
cell_r11_c16.png,11,16,887,221,920,232,33,11
cell_r11_c17.png,11,17,920,221,986,233,66,12
cell_r11_c18.png,11,18,986,221,1051,233,65,12
cell_r11_c0.png,11,0,1,220,16,231,15,11
cell_r11_c1.png,11,1,16,220,229,232,213,12
cell_r11_c2.png,11,2,229,220,280,232,51,12
cell_r11_c3.png,11,3,280,220,323,232,43,12
cell_r11_c4.png,11,4,323,220,359,232,36,12
cell_r11_c5.png,11,5,359,220,390,232,31,12
cell_r11_c6.png,11,6,390,220,446,232,56,12
cell_r11_c7.png,11,7,446,220,502,232,56,12
cell_r11_c8.png,11,8,502,220,538,232,36,12
cell_r11_c9.png,11,9,538,221,571,232,33,11
cell_r11_c10.png,11,10,571,221,627,232,56,11
cell_r11_c11.png,11,11,627,221,698,232,71,11
cell_r11_c12.png,11,12,698,221,734,232,36,11
cell_r11_c13.png,11,13,734,221,767,232,33,11
cell_r11_c14.png,11,14,767,221,822,233,55,12
cell_r11_c15.png,11,15,822,221,887,233,65,12
cell_r11_c16.png,11,16,887,221,920,232,33,11
cell_r11_c17.png,11,17,920,221,986,233,66,12
cell_r11_c18.png,11,18,986,221,1051,233,65,12
cell_r11_c0.png,11,0,1,220,16,231,15,11
cell_r11_c1.png,11,1,16,220,229,232,213,12
cell_r11_c2.png,11,2,229,220,280,232,51,12
cell_r11_c3.png,11,3,280,220,323,232,43,12
cell_r11_c4.png,11,4,323,220,359,232,36,12
cell_r11_c5.png,11,5,359,220,390,232,31,12
cell_r11_c6.png,11,6,390,220,446,232,56,12
cell_r11_c7.png,11,7,446,220,502,232,56,12
cell_r11_c8.png,11,8,502,220,538,232,36,12
cell_r11_c9.png,11,9,538,221,571,232,33,11
cell_r11_c10.png,11,10,571,221,627,232,56,11
cell_r11_c11.png,11,11,627,221,698,232,71,11
cell_r11_c12.png,11,12,698,221,734,232,36,11
cell_r11_c13.png,11,13,734,221,767,232,33,11
cell_r11_c14.png,11,14,767,221,822,233,55,12
cell_r11_c15.png,11,15,822,221,887,233,65,12
cell_r11_c16.png,11,16,887,221,920,232,33,11
cell_r11_c17.png,11,17,920,221,986,233,66,12
cell_r11_c18.png,11,18,986,221,1051,233,65,12
cell_r11_c0.png,11,0,1,220,16,231,15,11
cell_r11_c1.png,11,1,16,220,229,232,213,12
cell_r11_c2.png,11,2,229,220,280,232,51,12
cell_r11_c3.png,11,3,280,220,323,232,43,12
cell_r11_c4.png,11,4,323,220,359,232,36,12
cell_r11_c5.png,11,5,359,220,390,232,31,12
cell_r11_c6.png,11,6,390,220,446,232,56,12
cell_r11_c7.png,11,7,446,220,502,232,56,12
cell_r11_c8.png,11,8,502,220,538,232,36,12
cell_r11_c9.png,11,9,538,221,571,232,33,11
cell_r11_c10.png,11,10,571,221,627,232,56,11
cell_r11_c11.png,11,11,627,221,698,232,71,11
cell_r11_c12.png,11,12,698,221,734,232,36,11
cell_r11_c13.png,11,13,734,221,767,232,33,11
cell_r11_c14.png,11,14,767,221,822,233,55,12
cell_r11_c15.png,11,15,822,221,887,233,65,12
cell_r11_c16.png,11,16,887,221,920,232,33,11
cell_r11_c17.png,11,17,920,221,986,233,66,12
cell_r11_c18.png,11,18,986,221,1051,233,65,12
cell_r11_c0.png,11,0,1,220,16,231,15,11
cell_r11_c1.png,11,1,16,220,229,232,213,12
cell_r11_c2.png,11,2,229,220,280,232,51,12
cell_r11_c3.png,11,3,280,220,323,232,43,12
cell_r11_c4.png,11,4,323,220,359,232,36,12
cell_r11_c5.png,11,5,359,220,390,232,31,12
cell_r11_c6.png,11,6,390,220,446,232,56,12
cell_r11_c7.png,11,7,446,220,502,232,56,12
cell_r11_c8.png,11,8,502,220,538,232,36,12
cell_r11_c9.png,11,9,538,221,571,232,33,11
cell_r11_c10.png,11,10,571,221,627,232,56,11
cell_r11_c11.png,11,11,627,221,698,232,71,11
cell_r11_c12.png,11,12,698,221,734,232,36,11
cell_r11_c13.png,11,13,734,221,767,232,33,11
cell_r11_c14.png,11,14,767,221,822,233,55,12
cell_r11_c15.png,11,15,822,221,887,233,65,12
cell_r11_c16.png,11,16,887,221,920,232,33,11
cell_r11_c17.png,11,17,920,221,986,233,66,12
cell_r11_c18.png,11,18,986,221,1051,233,65,12
cell_r11_c0.png,11,0,1,220,16,231,15,11
cell_r11_c1.png,11,1,16,220,229,232,213,12
cell_r11_c2.png,11,2,229,220,280,232,51,12
cell_r11_c3.png,11,3,280,220,323,232,43,12
cell_r11_c4.png,11,4,323,220,359,232,36,12
cell_r11_c5.png,11,5,359,220,390,232,31,12
cell_r11_c6.png,11,6,390,220,446,232,56,12
cell_r11_c7.png,11,7,446,220,502,232,56,12
cell_r11_c8.png,11,8,502,220,538,232,36,12
cell_r11_c9.png,11,9,538,221,571,232,33,11
cell_r11_c10.png,11,10,571,221,627,232,56,11
cell_r11_c11.png,11,11,627,221,698,232,71,11
cell_r11_c12.png,11,12,698,221,734,232,36,11
cell_r11_c13.png,11,13,734,221,767,232,33,11
cell_r11_c14.png,11,14,767,221,822,233,55,12
cell_r11_c15.png,11,15,822,221,887,233,65,12
cell_r11_c16.png,11,16,887,221,920,232,33,11
cell_r11_c17.png,11,17,920,221,986,233,66,12
cell_r11_c18.png,11,18,986,221,1051,233,65,12
cell_r11_c0.png,11,0,1,220,16,231,15,11
cell_r11_c1.png,11,1,16,220,229,232,213,12
cell_r11_c2.png,11,2,229,220,280,232,51,12
cell_r11_c3.png,11,3,280,220,323,232,43,12
cell_r11_c4.png,11,4,323,220,359,232,36,12
cell_r11_c5.png,11,5,359,220,390,232,31,12
cell_r11_c6.png,11,6,390,220,446,232,56,12
cell_r11_c7.png,11,7,446,220,502,232,56,12
cell_r11_c8.png,11,8,502,220,538,232,36,12
cell_r11_c9.png,11,9,538,221,571,232,33,11
cell_r11_c10.png,11,10,571,221,627,232,56,11
cell_r11_c11.png,11,11,627,221,698,232,71,11
cell_r11_c12.png,11,12,698,221,734,232,36,11
cell_r11_c13.png,11,13,734,221,767,232,33,11
cell_r11_c14.png,11,14,767,221,822,233,55,12
cell_r11_c15.png,11,15,822,221,887,233,65,12
cell_r11_c16.png,11,16,887,221,920,232,33,11
cell_r11_c17.png,11,17,920,221,986,233,66,12
cell_r11_c18.png,11,18,986,221,1051,233,65,12
cell_r11_c0.png,11,0,1,220,16,231,15,11
cell_r11_c1.png,11,1,16,220,229,232,213,12
cell_r11_c2.png,11,2,229,220,280,232,51,12
cell_r11_c3.png,11,3,280,220,323,232,43,12
cell_r11_c4.png,11,4,323,220,359,232,36,12
cell_r11_c5.png,11,5,359,220,390,232,31,12
cell_r11_c6.png,11,6,390,220,446,232,56,12
cell_r11_c7.png,11,7,446,220,502,232,56,12
cell_r11_c8.png,11,8,502,220,538,232,36,12
cell_r11_c9.png,11,9,538,221,571,232,33,11
cell_r11_c10.png,11,10,571,221,627,232,56,11
cell_r11_c11.png,11,11,627,221,698,232,71,11
cell_r11_c12.png,11,12,698,221,734,232,36,11
cell_r11_c13.png,11,13,734,221,767,232,33,11
cell_r11_c14.png,11,14,767,221,822,233,55,12
cell_r11_c15.png,11,15,822,221,887,233,65,12
cell_r11_c16.png,11,16,887,221,920,232,33,11
cell_r11_c17.png,11,17,920,221,986,233,66,12
cell_r11_c18.png,11,18,986,221,1051,233,65,12
cell_r11_c0.png,11,0,1,220,16,231,15,11
cell_r11_c1.png,11,1,16,220,229,232,213,12
cell_r11_c2.png,11,2,229,220,280,232,51,12
cell_r11_c3.png,11,3,280,220,323,232,43,12
cell_r11_c4.png,11,4,323,220,359,232,36,12
cell_r11_c5.png,11,5,359,220,390,232,31,12
cell_r11_c6.png,11,6,390,220,446,232,56,12
cell_r11_c7.png,11,7,446,220,502,232,56,12
cell_r11_c8.png,11,8,502,220,538,232,36,12
cell_r11_c9.png,11,9,538,221,571,232,33,11
cell_r11_c10.png,11,10,571,221,627,232,56,11
cell_r11_c11.png,11,11,627,221,698,232,71,11
cell_r11_c12.png,11,12,698,221,734,232,36,11
cell_r11_c13.png,11,13,734,221,767,232,33,11
cell_r11_c14.png,11,14,767,221,822,233,55,12
cell_r11_c15.png,11,15,822,221,887,233,65,12
cell_r11_c16.png,11,16,887,221,920,232,33,11
cell_r11_c17.png,11,17,920,221,986,233,66,12
cell_r11_c18.png,11,18,986,221,1051,233,65,12
cell_r11_c0.png,11,0,1,220,16,231,15,11
cell_r11_c1.png,11,1,16,220,229,232,213,12
cell_r11_c2.png,11,2,229,220,280,232,51,12
cell_r11_c3.png,11,3,280,220,323,232,43,12
cell_r11_c4.png,11,4,323,220,359,232,36,12
cell_r11_c5.png,11,5,359,220,390,232,31,12
cell_r11_c6.png,11,6,390,220,446,232,56,12
cell_r11_c7.png,11,7,446,220,502,232,56,12
cell_r11_c8.png,11,8,502,220,538,232,36,12
cell_r11_c9.png,11,9,538,221,571,232,33,11
cell_r11_c10.png,11,10,571,221,627,232,56,11
cell_r11_c11.png,11,11,627,221,698,232,71,11
cell_r11_c12.png,11,12,698,221,734,232,36,11
cell_r11_c13.png,11,13,734,221,767,232,33,11
cell_r11_c14.png,11,14,767,221,822,233,55,12
cell_r11_c15.png,11,15,822,221,887,233,65,12
cell_r11_c16.png,11,16,887,221,920,232,33,11
cell_r11_c17.png,11,17,920,221,986,233,66,12
cell_r11_c18.png,11,18,986,221,1051,233,65,12
cell_r11_c0.png,11,0,1,220,16,231,15,11
cell_r11_c1.png,11,1,16,220,229,232,213,12
cell_r11_c2.png,11,2,229,220,280,232,51,12
cell_r11_c3.png,11,3,280,220,323,232,43,12
cell_r11_c4.png,11,4,323,220,359,232,36,12
cell_r11_c5.png,11,5,359,220,390,232,31,12
cell_r11_c6.png,11,6,390,220,446,232,56,12
cell_r11_c7.png,11,7,446,220,502,232,56,12
cell_r11_c8.png,11,8,502,220,538,232,36,12
cell_r11_c9.png,11,9,538,221,571,232,33,11
cell_r11_c10.png,11,10,571,221,627,232,56,11
cell_r11_c11.png,11,11,627,221,698,232,71,11
cell_r11_c12.png,11,12,698,221,734,232,36,11
cell_r11_c13.png,11,13,734,221,767,232,33,11
cell_r11_c14.png,11,14,767,221,822,233,55,12
cell_r11_c15.png,11,15,822,221,887,233,65,12
cell_r11_c16.png,11,16,887,221,920,232,33,11
cell_r11_c17.png,11,17,920,221,986,233,66,12
cell_r11_c18.png,11,18,986,221,1051,233,65,12
cell_r11_c0.png,11,0,1,220,16,231,15,11
cell_r11_c1.png,11,1,16,220,229,232,213,12
cell_r11_c2.png,11,2,229,220,280,232,51,12
cell_r11_c3.png,11,3,280,220,323,232,43,12
cell_r11_c4.png,11,4,323,220,359,232,36,12
cell_r11_c5.png,11,5,359,220,390,232,31,12
cell_r11_c6.png,11,6,390,220,446,232,56,12
cell_r11_c7.png,11,7,446,220,502,232,56,12
cell_r11_c8.png,11,8,502,220,538,232,36,12
cell_r11_c9.png,11,9,538,221,571,232,33,11
cell_r11_c10.png,11,10,571,221,627,232,56,11
cell_r11_c11.png,11,11,627,221,698,232,71,11
cell_r11_c12.png,11,12,698,221,734,232,36,11
cell_r11_c13.png,11,13,734,221,767,232,33,11
cell_r11_c14.png,11,14,767,221,822,233,55,12
cell_r11_c15.png,11,15,822,221,887,233,65,12
cell_r11_c16.png,11,16,887,221,920,232,33,11
cell_r11_c17.png,11,17,920,221,986,233,66,12
cell_r11_c18.png,11,18,986,221,1051,233,65,12
cell_r11_c0.png,11,0,1,220,16,231,15,11
cell_r11_c1.png,11,1,16,220,229,232,213,12
cell_r11_c2.png,11,2,229,220,280,232,51,12
cell_r11_c3.png,11,3,280,220,323,232,43,12
cell_r11_c4.png,11,4,323,220,359,232,36,12
cell_r11_c5.png,11,5,359,220,390,232,31,12
cell_r11_c6.png,11,6,390,220,446,232,56,12
cell_r11_c7.png,11,7,446,220,502,232,56,12
cell_r11_c8.png,11,8,502,220,538,232,36,12
cell_r11_c9.png,11,9,538,221,571,232,33,11
cell_r11_c10.png,11,10,571,221,627,232,56,11
cell_r11_c11.png,11,11,627,221,698,232,71,11
cell_r11_c12.png,11,12,698,221,734,232,36,11
cell_r11_c13.png,11,13,734,221,767,232,33,11
cell_r11_c14.png,11,14,767,221,822,233,55,12
cell_r11_c15.png,11,15,822,221,887,233,65,12
cell_r11_c16.png,11,16,887,221,920,232,33,11
cell_r11_c17.png,11,17,920,221,986,233,66,12
cell_r11_c18.png,11,18,986,221,1051,233,65,12
cell_r11_c0.png,11,0,1,220,16,231,15,11
cell_r11_c1.png,11,1,16,220,229,232,213,12
cell_r11_c2.png,11,2,229,220,280,232,51,12
cell_r11_c3.png,11,3,280,220,323,232,43,12
cell_r11_c4.png,11,4,323,220,359,232,36,12
cell_r11_c5.png,11,5,359,220,390,232,31,12
cell_r11_c6.png,11,6,390,220,446,232,56,12
cell_r11_c7.png,11,7,446,220,502,232,56,12
cell_r11_c8.png,11,8,502,220,538,232,36,12
cell_r11_c9.png,11,9,538,221,571,232,33,11
cell_r11_c10.png,11,10,571,221,627,232,56,11
cell_r11_c11.png,11,11,627,221,698,232,71,11
cell_r11_c12.png,11,12,698,221,734,232,36,11
cell_r11_c13.png,11,13,734,221,767,232,33,11
cell_r11_c14.png,11,14,767,221,822,233,55,12
cell_r11_c15.png,11,15,822,221,887,233,65,12
cell_r11_c16.png,11,16,887,221,920,232,33,11
cell_r11_c17.png,11,17,920,221,986,233,66,12
cell_r11_c18.png,11,18,986,221,1051,233,65,12
cell_r12_c0.png,12,0,1,231,16,250,15,19
cell_r12_c1.png,12,1,16,231,230,250,214,19
cell_r12_c2.png,12,2,229,232,280,250,51,18
cell_r12_c3.png,12,3,279,232,323,250,44,18
cell_r12_c4.png,12,4,323,232,359,250,36,18
cell_r12_c5.png,12,5,359,232,391,250,32,18
cell_r12_c6.png,12,6,390,232,446,251,56,19
cell_r12_c7.png,12,7,446,232,502,251,56,19
cell_r12_c8.png,12,8,502,232,538,250,36,18
cell_r12_c9.png,12,9,538,232,571,250,33,18
cell_r12_c10.png,12,10,570,232,627,251,57,19
cell_r12_c11.png,12,11,627,232,698,251,71,19
cell_r12_c12.png,12,12,698,232,734,251,36,19
cell_r12_c13.png,12,13,734,232,767,251,33,19
cell_r12_c14.png,12,14,767,232,822,251,55,19
cell_r12_c15.png,12,15,822,232,887,252,65,20
cell_r12_c16.png,12,16,887,232,920,252,33,20
cell_r12_c17.png,12,17,920,232,986,252,66,20
cell_r12_c18.png,12,18,986,233,1051,251,65,18
cell_r12_c0.png,12,0,1,231,16,250,15,19
cell_r12_c1.png,12,1,16,231,230,250,214,19
cell_r12_c2.png,12,2,229,232,280,250,51,18
cell_r12_c3.png,12,3,279,232,323,250,44,18
cell_r12_c4.png,12,4,323,232,359,250,36,18
cell_r12_c5.png,12,5,359,232,391,250,32,18
cell_r12_c6.png,12,6,390,232,446,251,56,19
cell_r12_c7.png,12,7,446,232,502,251,56,19
cell_r12_c8.png,12,8,502,232,538,250,36,18
cell_r12_c9.png,12,9,538,232,571,250,33,18
cell_r12_c10.png,12,10,570,232,627,251,57,19
cell_r12_c11.png,12,11,627,232,698,251,71,19
cell_r12_c12.png,12,12,698,232,734,251,36,19
cell_r12_c13.png,12,13,734,232,767,251,33,19
cell_r12_c14.png,12,14,767,232,822,251,55,19
cell_r12_c15.png,12,15,822,232,887,252,65,20
cell_r12_c16.png,12,16,887,232,920,252,33,20
cell_r12_c17.png,12,17,920,232,986,252,66,20
cell_r12_c18.png,12,18,986,233,1051,251,65,18
cell_r12_c0.png,12,0,1,231,16,250,15,19
cell_r12_c1.png,12,1,16,231,230,250,214,19
cell_r12_c2.png,12,2,229,232,280,250,51,18
cell_r12_c3.png,12,3,279,232,323,250,44,18
cell_r12_c4.png,12,4,323,232,359,250,36,18
cell_r12_c5.png,12,5,359,232,391,250,32,18
cell_r12_c6.png,12,6,390,232,446,251,56,19
cell_r12_c7.png,12,7,446,232,502,251,56,19
cell_r12_c8.png,12,8,502,232,538,250,36,18
cell_r12_c9.png,12,9,538,232,571,250,33,18
cell_r12_c10.png,12,10,570,232,627,251,57,19
cell_r12_c11.png,12,11,627,232,698,251,71,19
cell_r12_c12.png,12,12,698,232,734,251,36,19
cell_r12_c13.png,12,13,734,232,767,251,33,19
cell_r12_c14.png,12,14,767,232,822,251,55,19
cell_r12_c15.png,12,15,822,232,887,252,65,20
cell_r12_c16.png,12,16,887,232,920,252,33,20
cell_r12_c17.png,12,17,920,232,986,252,66,20
cell_r12_c18.png,12,18,986,233,1051,251,65,18
cell_r12_c0.png,12,0,1,231,16,250,15,19
cell_r12_c1.png,12,1,16,231,230,250,214,19
cell_r12_c2.png,12,2,229,232,280,250,51,18
cell_r12_c3.png,12,3,279,232,323,250,44,18
cell_r12_c4.png,12,4,323,232,359,250,36,18
cell_r12_c5.png,12,5,359,232,391,250,32,18
cell_r12_c6.png,12,6,390,232,446,251,56,19
cell_r12_c7.png,12,7,446,232,502,251,56,19
cell_r12_c8.png,12,8,502,232,538,250,36,18
cell_r12_c9.png,12,9,538,232,571,250,33,18
cell_r12_c10.png,12,10,570,232,627,251,57,19
cell_r12_c11.png,12,11,627,232,698,251,71,19
cell_r12_c12.png,12,12,698,232,734,251,36,19
cell_r12_c13.png,12,13,734,232,767,251,33,19
cell_r12_c14.png,12,14,767,232,822,251,55,19
cell_r12_c15.png,12,15,822,232,887,252,65,20
cell_r12_c16.png,12,16,887,232,920,252,33,20
cell_r12_c17.png,12,17,920,232,986,252,66,20
cell_r12_c18.png,12,18,986,233,1051,251,65,18
cell_r12_c0.png,12,0,1,231,16,250,15,19
cell_r12_c1.png,12,1,16,231,230,250,214,19
cell_r12_c2.png,12,2,229,232,280,250,51,18
cell_r12_c3.png,12,3,279,232,323,250,44,18
cell_r12_c4.png,12,4,323,232,359,250,36,18
cell_r12_c5.png,12,5,359,232,391,250,32,18
cell_r12_c6.png,12,6,390,232,446,251,56,19
cell_r12_c7.png,12,7,446,232,502,251,56,19
cell_r12_c8.png,12,8,502,232,538,250,36,18
cell_r12_c9.png,12,9,538,232,571,250,33,18
cell_r12_c10.png,12,10,570,232,627,251,57,19
cell_r12_c11.png,12,11,627,232,698,251,71,19
cell_r12_c12.png,12,12,698,232,734,251,36,19
cell_r12_c13.png,12,13,734,232,767,251,33,19
cell_r12_c14.png,12,14,767,232,822,251,55,19
cell_r12_c15.png,12,15,822,232,887,252,65,20
cell_r12_c16.png,12,16,887,232,920,252,33,20
cell_r12_c17.png,12,17,920,232,986,252,66,20
cell_r12_c18.png,12,18,986,233,1051,251,65,18
cell_r12_c0.png,12,0,1,231,16,250,15,19
cell_r12_c1.png,12,1,16,231,230,250,214,19
cell_r12_c2.png,12,2,229,232,280,250,51,18
cell_r12_c3.png,12,3,279,232,323,250,44,18
cell_r12_c4.png,12,4,323,232,359,250,36,18
cell_r12_c5.png,12,5,359,232,391,250,32,18
cell_r12_c6.png,12,6,390,232,446,251,56,19
cell_r12_c7.png,12,7,446,232,502,251,56,19
cell_r12_c8.png,12,8,502,232,538,250,36,18
cell_r12_c9.png,12,9,538,232,571,250,33,18
cell_r12_c10.png,12,10,570,232,627,251,57,19
cell_r12_c11.png,12,11,627,232,698,251,71,19
cell_r12_c12.png,12,12,698,232,734,251,36,19
cell_r12_c13.png,12,13,734,232,767,251,33,19
cell_r12_c14.png,12,14,767,232,822,251,55,19
cell_r12_c15.png,12,15,822,232,887,252,65,20
cell_r12_c16.png,12,16,887,232,920,252,33,20
cell_r12_c17.png,12,17,920,232,986,252,66,20
cell_r12_c18.png,12,18,986,233,1051,251,65,18
cell_r12_c0.png,12,0,1,231,16,250,15,19
cell_r12_c1.png,12,1,16,231,230,250,214,19
cell_r12_c2.png,12,2,229,232,280,250,51,18
cell_r12_c3.png,12,3,279,232,323,250,44,18
cell_r12_c4.png,12,4,323,232,359,250,36,18
cell_r12_c5.png,12,5,359,232,391,250,32,18
cell_r12_c6.png,12,6,390,232,446,251,56,19
cell_r12_c7.png,12,7,446,232,502,251,56,19
cell_r12_c8.png,12,8,502,232,538,250,36,18
cell_r12_c9.png,12,9,538,232,571,250,33,18
cell_r12_c10.png,12,10,570,232,627,251,57,19
cell_r12_c11.png,12,11,627,232,698,251,71,19
cell_r12_c12.png,12,12,698,232,734,251,36,19
cell_r12_c13.png,12,13,734,232,767,251,33,19
cell_r12_c14.png,12,14,767,232,822,251,55,19
cell_r12_c15.png,12,15,822,232,887,252,65,20
cell_r12_c16.png,12,16,887,232,920,252,33,20
cell_r12_c17.png,12,17,920,232,986,252,66,20
cell_r12_c18.png,12,18,986,233,1051,251,65,18
cell_r12_c0.png,12,0,1,231,16,250,15,19
cell_r12_c1.png,12,1,16,231,230,250,214,19
cell_r12_c2.png,12,2,229,232,280,250,51,18
cell_r12_c3.png,12,3,279,232,323,250,44,18
cell_r12_c4.png,12,4,323,232,359,250,36,18
cell_r12_c5.png,12,5,359,232,391,250,32,18
cell_r12_c6.png,12,6,390,232,446,251,56,19
cell_r12_c7.png,12,7,446,232,502,251,56,19
cell_r12_c8.png,12,8,502,232,538,250,36,18
cell_r12_c9.png,12,9,538,232,571,250,33,18
cell_r12_c10.png,12,10,570,232,627,251,57,19
cell_r12_c11.png,12,11,627,232,698,251,71,19
cell_r12_c12.png,12,12,698,232,734,251,36,19
cell_r12_c13.png,12,13,734,232,767,251,33,19
cell_r12_c14.png,12,14,767,232,822,251,55,19
cell_r12_c15.png,12,15,822,232,887,252,65,20
cell_r12_c16.png,12,16,887,232,920,252,33,20
cell_r12_c17.png,12,17,920,232,986,252,66,20
cell_r12_c18.png,12,18,986,233,1051,251,65,18
cell_r12_c0.png,12,0,1,231,16,250,15,19
cell_r12_c1.png,12,1,16,231,230,250,214,19
cell_r12_c2.png,12,2,229,232,280,250,51,18
cell_r12_c3.png,12,3,279,232,323,250,44,18
cell_r12_c4.png,12,4,323,232,359,250,36,18
cell_r12_c5.png,12,5,359,232,391,250,32,18
cell_r12_c6.png,12,6,390,232,446,251,56,19
cell_r12_c7.png,12,7,446,232,502,251,56,19
cell_r12_c8.png,12,8,502,232,538,250,36,18
cell_r12_c9.png,12,9,538,232,571,250,33,18
cell_r12_c10.png,12,10,570,232,627,251,57,19
cell_r12_c11.png,12,11,627,232,698,251,71,19
cell_r12_c12.png,12,12,698,232,734,251,36,19
cell_r12_c13.png,12,13,734,232,767,251,33,19
cell_r12_c14.png,12,14,767,232,822,251,55,19
cell_r12_c15.png,12,15,822,232,887,252,65,20
cell_r12_c16.png,12,16,887,232,920,252,33,20
cell_r12_c17.png,12,17,920,232,986,252,66,20
cell_r12_c18.png,12,18,986,233,1051,251,65,18
cell_r12_c0.png,12,0,1,231,16,250,15,19
cell_r12_c1.png,12,1,16,231,230,250,214,19
cell_r12_c2.png,12,2,229,232,280,250,51,18
cell_r12_c3.png,12,3,279,232,323,250,44,18
cell_r12_c4.png,12,4,323,232,359,250,36,18
cell_r12_c5.png,12,5,359,232,391,250,32,18
cell_r12_c6.png,12,6,390,232,446,251,56,19
cell_r12_c7.png,12,7,446,232,502,251,56,19
cell_r12_c8.png,12,8,502,232,538,250,36,18
cell_r12_c9.png,12,9,538,232,571,250,33,18
cell_r12_c10.png,12,10,570,232,627,251,57,19
cell_r12_c11.png,12,11,627,232,698,251,71,19
cell_r12_c12.png,12,12,698,232,734,251,36,19
cell_r12_c13.png,12,13,734,232,767,251,33,19
cell_r12_c14.png,12,14,767,232,822,251,55,19
cell_r12_c15.png,12,15,822,232,887,252,65,20
cell_r12_c16.png,12,16,887,232,920,252,33,20
cell_r12_c17.png,12,17,920,232,986,252,66,20
cell_r12_c18.png,12,18,986,233,1051,251,65,18
cell_r12_c0.png,12,0,1,231,16,250,15,19
cell_r12_c1.png,12,1,16,231,230,250,214,19
cell_r12_c2.png,12,2,229,232,280,250,51,18
cell_r12_c3.png,12,3,279,232,323,250,44,18
cell_r12_c4.png,12,4,323,232,359,250,36,18
cell_r12_c5.png,12,5,359,232,391,250,32,18
cell_r12_c6.png,12,6,390,232,446,251,56,19
cell_r12_c7.png,12,7,446,232,502,251,56,19
cell_r12_c8.png,12,8,502,232,538,250,36,18
cell_r12_c9.png,12,9,538,232,571,250,33,18
cell_r12_c10.png,12,10,570,232,627,251,57,19
cell_r12_c11.png,12,11,627,232,698,251,71,19
cell_r12_c12.png,12,12,698,232,734,251,36,19
cell_r12_c13.png,12,13,734,232,767,251,33,19
cell_r12_c14.png,12,14,767,232,822,251,55,19
cell_r12_c15.png,12,15,822,232,887,252,65,20
cell_r12_c16.png,12,16,887,232,920,252,33,20
cell_r12_c17.png,12,17,920,232,986,252,66,20
cell_r12_c18.png,12,18,986,233,1051,251,65,18
cell_r12_c0.png,12,0,1,231,16,250,15,19
cell_r12_c1.png,12,1,16,231,230,250,214,19
cell_r12_c2.png,12,2,229,232,280,250,51,18
cell_r12_c3.png,12,3,279,232,323,250,44,18
cell_r12_c4.png,12,4,323,232,359,250,36,18
cell_r12_c5.png,12,5,359,232,391,250,32,18
cell_r12_c6.png,12,6,390,232,446,251,56,19
cell_r12_c7.png,12,7,446,232,502,251,56,19
cell_r12_c8.png,12,8,502,232,538,250,36,18
cell_r12_c9.png,12,9,538,232,571,250,33,18
cell_r12_c10.png,12,10,570,232,627,251,57,19
cell_r12_c11.png,12,11,627,232,698,251,71,19
cell_r12_c12.png,12,12,698,232,734,251,36,19
cell_r12_c13.png,12,13,734,232,767,251,33,19
cell_r12_c14.png,12,14,767,232,822,251,55,19
cell_r12_c15.png,12,15,822,232,887,252,65,20
cell_r12_c16.png,12,16,887,232,920,252,33,20
cell_r12_c17.png,12,17,920,232,986,252,66,20
cell_r12_c18.png,12,18,986,233,1051,251,65,18
cell_r12_c0.png,12,0,1,231,16,250,15,19
cell_r12_c1.png,12,1,16,231,230,250,214,19
cell_r12_c2.png,12,2,229,232,280,250,51,18
cell_r12_c3.png,12,3,279,232,323,250,44,18
cell_r12_c4.png,12,4,323,232,359,250,36,18
cell_r12_c5.png,12,5,359,232,391,250,32,18
cell_r12_c6.png,12,6,390,232,446,251,56,19
cell_r12_c7.png,12,7,446,232,502,251,56,19
cell_r12_c8.png,12,8,502,232,538,250,36,18
cell_r12_c9.png,12,9,538,232,571,250,33,18
cell_r12_c10.png,12,10,570,232,627,251,57,19
cell_r12_c11.png,12,11,627,232,698,251,71,19
cell_r12_c12.png,12,12,698,232,734,251,36,19
cell_r12_c13.png,12,13,734,232,767,251,33,19
cell_r12_c14.png,12,14,767,232,822,251,55,19
cell_r12_c15.png,12,15,822,232,887,252,65,20
cell_r12_c16.png,12,16,887,232,920,252,33,20
cell_r12_c17.png,12,17,920,232,986,252,66,20
cell_r12_c18.png,12,18,986,233,1051,251,65,18
cell_r12_c0.png,12,0,1,231,16,250,15,19
cell_r12_c1.png,12,1,16,231,230,250,214,19
cell_r12_c2.png,12,2,229,232,280,250,51,18
cell_r12_c3.png,12,3,279,232,323,250,44,18
cell_r12_c4.png,12,4,323,232,359,250,36,18
cell_r12_c5.png,12,5,359,232,391,250,32,18
cell_r12_c6.png,12,6,390,232,446,251,56,19
cell_r12_c7.png,12,7,446,232,502,251,56,19
cell_r12_c8.png,12,8,502,232,538,250,36,18
cell_r12_c9.png,12,9,538,232,571,250,33,18
cell_r12_c10.png,12,10,570,232,627,251,57,19
cell_r12_c11.png,12,11,627,232,698,251,71,19
cell_r12_c12.png,12,12,698,232,734,251,36,19
cell_r12_c13.png,12,13,734,232,767,251,33,19
cell_r12_c14.png,12,14,767,232,822,251,55,19
cell_r12_c15.png,12,15,822,232,887,252,65,20
cell_r12_c16.png,12,16,887,232,920,252,33,20
cell_r12_c17.png,12,17,920,232,986,252,66,20
cell_r12_c18.png,12,18,986,233,1051,251,65,18
cell_r12_c0.png,12,0,1,231,16,250,15,19
cell_r12_c1.png,12,1,16,231,230,250,214,19
cell_r12_c2.png,12,2,229,232,280,250,51,18
cell_r12_c3.png,12,3,279,232,323,250,44,18
cell_r12_c4.png,12,4,323,232,359,250,36,18
cell_r12_c5.png,12,5,359,232,391,250,32,18
cell_r12_c6.png,12,6,390,232,446,251,56,19
cell_r12_c7.png,12,7,446,232,502,251,56,19
cell_r12_c8.png,12,8,502,232,538,250,36,18
cell_r12_c9.png,12,9,538,232,571,250,33,18
cell_r12_c10.png,12,10,570,232,627,251,57,19
cell_r12_c11.png,12,11,627,232,698,251,71,19
cell_r12_c12.png,12,12,698,232,734,251,36,19
cell_r12_c13.png,12,13,734,232,767,251,33,19
cell_r12_c14.png,12,14,767,232,822,251,55,19
cell_r12_c15.png,12,15,822,232,887,252,65,20
cell_r12_c16.png,12,16,887,232,920,252,33,20
cell_r12_c17.png,12,17,920,232,986,252,66,20
cell_r12_c18.png,12,18,986,233,1051,251,65,18
cell_r12_c0.png,12,0,1,231,16,250,15,19
cell_r12_c1.png,12,1,16,231,230,250,214,19
cell_r12_c2.png,12,2,229,232,280,250,51,18
cell_r12_c3.png,12,3,279,232,323,250,44,18
cell_r12_c4.png,12,4,323,232,359,250,36,18
cell_r12_c5.png,12,5,359,232,391,250,32,18
cell_r12_c6.png,12,6,390,232,446,251,56,19
cell_r12_c7.png,12,7,446,232,502,251,56,19
cell_r12_c8.png,12,8,502,232,538,250,36,18
cell_r12_c9.png,12,9,538,232,571,250,33,18
cell_r12_c10.png,12,10,570,232,627,251,57,19
cell_r12_c11.png,12,11,627,232,698,251,71,19
cell_r12_c12.png,12,12,698,232,734,251,36,19
cell_r12_c13.png,12,13,734,232,767,251,33,19
cell_r12_c14.png,12,14,767,232,822,251,55,19
cell_r12_c15.png,12,15,822,232,887,252,65,20
cell_r12_c16.png,12,16,887,232,920,252,33,20
cell_r12_c17.png,12,17,920,232,986,252,66,20
cell_r12_c18.png,12,18,986,233,1051,251,65,18
cell_r12_c0.png,12,0,1,231,16,250,15,19
cell_r12_c1.png,12,1,16,231,230,250,214,19
cell_r12_c2.png,12,2,229,232,280,250,51,18
cell_r12_c3.png,12,3,279,232,323,250,44,18
cell_r12_c4.png,12,4,323,232,359,250,36,18
cell_r12_c5.png,12,5,359,232,391,250,32,18
cell_r12_c6.png,12,6,390,232,446,251,56,19
cell_r12_c7.png,12,7,446,232,502,251,56,19
cell_r12_c8.png,12,8,502,232,538,250,36,18
cell_r12_c9.png,12,9,538,232,571,250,33,18
cell_r12_c10.png,12,10,570,232,627,251,57,19
cell_r12_c11.png,12,11,627,232,698,251,71,19
cell_r12_c12.png,12,12,698,232,734,251,36,19
cell_r12_c13.png,12,13,734,232,767,251,33,19
cell_r12_c14.png,12,14,767,232,822,251,55,19
cell_r12_c15.png,12,15,822,232,887,252,65,20
cell_r12_c16.png,12,16,887,232,920,252,33,20
cell_r12_c17.png,12,17,920,232,986,252,66,20
cell_r12_c18.png,12,18,986,233,1051,251,65,18
cell_r12_c0.png,12,0,1,231,16,250,15,19
cell_r12_c1.png,12,1,16,231,230,250,214,19
cell_r12_c2.png,12,2,229,232,280,250,51,18
cell_r12_c3.png,12,3,279,232,323,250,44,18
cell_r12_c4.png,12,4,323,232,359,250,36,18
cell_r12_c5.png,12,5,359,232,391,250,32,18
cell_r12_c6.png,12,6,390,232,446,251,56,19
cell_r12_c7.png,12,7,446,232,502,251,56,19
cell_r12_c8.png,12,8,502,232,538,250,36,18
cell_r12_c9.png,12,9,538,232,571,250,33,18
cell_r12_c10.png,12,10,570,232,627,251,57,19
cell_r12_c11.png,12,11,627,232,698,251,71,19
cell_r12_c12.png,12,12,698,232,734,251,36,19
cell_r12_c13.png,12,13,734,232,767,251,33,19
cell_r12_c14.png,12,14,767,232,822,251,55,19
cell_r12_c15.png,12,15,822,232,887,252,65,20
cell_r12_c16.png,12,16,887,232,920,252,33,20
cell_r12_c17.png,12,17,920,232,986,252,66,20
cell_r12_c18.png,12,18,986,233,1051,251,65,18
cell_r12_c0.png,12,0,1,231,16,250,15,19
cell_r12_c1.png,12,1,16,231,230,250,214,19
cell_r12_c2.png,12,2,229,232,280,250,51,18
cell_r12_c3.png,12,3,279,232,323,250,44,18
cell_r12_c4.png,12,4,323,232,359,250,36,18
cell_r12_c5.png,12,5,359,232,391,250,32,18
cell_r12_c6.png,12,6,390,232,446,251,56,19
cell_r12_c7.png,12,7,446,232,502,251,56,19
cell_r12_c8.png,12,8,502,232,538,250,36,18
cell_r12_c9.png,12,9,538,232,571,250,33,18
cell_r12_c10.png,12,10,570,232,627,251,57,19
cell_r12_c11.png,12,11,627,232,698,251,71,19
cell_r12_c12.png,12,12,698,232,734,251,36,19
cell_r12_c13.png,12,13,734,232,767,251,33,19
cell_r12_c14.png,12,14,767,232,822,251,55,19
cell_r12_c15.png,12,15,822,232,887,252,65,20
cell_r12_c16.png,12,16,887,232,920,252,33,20
cell_r12_c17.png,12,17,920,232,986,252,66,20
cell_r12_c18.png,12,18,986,233,1051,251,65,18
cell_r13_c0.png,13,0,1,250,16,260,15,10
cell_r13_c1.png,13,1,16,250,230,261,214,11
cell_r13_c2.png,13,2,229,250,279,261,50,11
cell_r13_c3.png,13,3,279,250,323,261,44,11
cell_r13_c4.png,13,4,323,250,359,261,36,11
cell_r13_c5.png,13,5,359,250,391,261,32,11
cell_r13_c6.png,13,6,391,250,446,261,55,11
cell_r13_c7.png,13,7,446,250,502,262,56,12
cell_r13_c8.png,13,8,502,250,538,262,36,12
cell_r13_c9.png,13,9,538,250,570,262,32,12
cell_r13_c10.png,13,10,570,250,627,262,57,12
cell_r13_c11.png,13,11,627,251,698,262,71,11
cell_r13_c12.png,13,12,698,251,734,262,36,11
cell_r13_c13.png,13,13,734,251,767,262,33,11
cell_r13_c14.png,13,14,767,251,822,262,55,11
cell_r13_c15.png,13,15,822,251,887,262,65,11
cell_r13_c16.png,13,16,887,252,920,262,33,10
cell_r13_c17.png,13,17,920,251,986,262,66,11
cell_r13_c18.png,13,18,986,251,1051,262,65,11
cell_r13_c0.png,13,0,1,250,16,260,15,10
cell_r13_c1.png,13,1,16,250,230,261,214,11
cell_r13_c2.png,13,2,229,250,279,261,50,11
cell_r13_c3.png,13,3,279,250,323,261,44,11
cell_r13_c4.png,13,4,323,250,359,261,36,11
cell_r13_c5.png,13,5,359,250,391,261,32,11
cell_r13_c6.png,13,6,391,250,446,261,55,11
cell_r13_c7.png,13,7,446,250,502,262,56,12
cell_r13_c8.png,13,8,502,250,538,262,36,12
cell_r13_c9.png,13,9,538,250,570,262,32,12
cell_r13_c10.png,13,10,570,250,627,262,57,12
cell_r13_c11.png,13,11,627,251,698,262,71,11
cell_r13_c12.png,13,12,698,251,734,262,36,11
cell_r13_c13.png,13,13,734,251,767,262,33,11
cell_r13_c14.png,13,14,767,251,822,262,55,11
cell_r13_c15.png,13,15,822,251,887,262,65,11
cell_r13_c16.png,13,16,887,252,920,262,33,10
cell_r13_c17.png,13,17,920,251,986,262,66,11
cell_r13_c18.png,13,18,986,251,1051,262,65,11
cell_r13_c0.png,13,0,1,250,16,260,15,10
cell_r13_c1.png,13,1,16,250,230,261,214,11
cell_r13_c2.png,13,2,229,250,279,261,50,11
cell_r13_c3.png,13,3,279,250,323,261,44,11
cell_r13_c4.png,13,4,323,250,359,261,36,11
cell_r13_c5.png,13,5,359,250,391,261,32,11
cell_r13_c6.png,13,6,391,250,446,261,55,11
cell_r13_c7.png,13,7,446,250,502,262,56,12
cell_r13_c8.png,13,8,502,250,538,262,36,12
cell_r13_c9.png,13,9,538,250,570,262,32,12
cell_r13_c10.png,13,10,570,250,627,262,57,12
cell_r13_c11.png,13,11,627,251,698,262,71,11
cell_r13_c12.png,13,12,698,251,734,262,36,11
cell_r13_c13.png,13,13,734,251,767,262,33,11
cell_r13_c14.png,13,14,767,251,822,262,55,11
cell_r13_c15.png,13,15,822,251,887,262,65,11
cell_r13_c16.png,13,16,887,252,920,262,33,10
cell_r13_c17.png,13,17,920,251,986,262,66,11
cell_r13_c18.png,13,18,986,251,1051,262,65,11
cell_r13_c0.png,13,0,1,250,16,260,15,10
cell_r13_c1.png,13,1,16,250,230,261,214,11
cell_r13_c2.png,13,2,229,250,279,261,50,11
cell_r13_c3.png,13,3,279,250,323,261,44,11
cell_r13_c4.png,13,4,323,250,359,261,36,11
cell_r13_c5.png,13,5,359,250,391,261,32,11
cell_r13_c6.png,13,6,391,250,446,261,55,11
cell_r13_c7.png,13,7,446,250,502,262,56,12
cell_r13_c8.png,13,8,502,250,538,262,36,12
cell_r13_c9.png,13,9,538,250,570,262,32,12
cell_r13_c10.png,13,10,570,250,627,262,57,12
cell_r13_c11.png,13,11,627,251,698,262,71,11
cell_r13_c12.png,13,12,698,251,734,262,36,11
cell_r13_c13.png,13,13,734,251,767,262,33,11
cell_r13_c14.png,13,14,767,251,822,262,55,11
cell_r13_c15.png,13,15,822,251,887,262,65,11
cell_r13_c16.png,13,16,887,252,920,262,33,10
cell_r13_c17.png,13,17,920,251,986,262,66,11
cell_r13_c18.png,13,18,986,251,1051,262,65,11
cell_r13_c0.png,13,0,1,250,16,260,15,10
cell_r13_c1.png,13,1,16,250,230,261,214,11
cell_r13_c2.png,13,2,229,250,279,261,50,11
cell_r13_c3.png,13,3,279,250,323,261,44,11
cell_r13_c4.png,13,4,323,250,359,261,36,11
cell_r13_c5.png,13,5,359,250,391,261,32,11
cell_r13_c6.png,13,6,391,250,446,261,55,11
cell_r13_c7.png,13,7,446,250,502,262,56,12
cell_r13_c8.png,13,8,502,250,538,262,36,12
cell_r13_c9.png,13,9,538,250,570,262,32,12
cell_r13_c10.png,13,10,570,250,627,262,57,12
cell_r13_c11.png,13,11,627,251,698,262,71,11
cell_r13_c12.png,13,12,698,251,734,262,36,11
cell_r13_c13.png,13,13,734,251,767,262,33,11
cell_r13_c14.png,13,14,767,251,822,262,55,11
cell_r13_c15.png,13,15,822,251,887,262,65,11
cell_r13_c16.png,13,16,887,252,920,262,33,10
cell_r13_c17.png,13,17,920,251,986,262,66,11
cell_r13_c18.png,13,18,986,251,1051,262,65,11
cell_r13_c0.png,13,0,1,250,16,260,15,10
cell_r13_c1.png,13,1,16,250,230,261,214,11
cell_r13_c2.png,13,2,229,250,279,261,50,11
cell_r13_c3.png,13,3,279,250,323,261,44,11
cell_r13_c4.png,13,4,323,250,359,261,36,11
cell_r13_c5.png,13,5,359,250,391,261,32,11
cell_r13_c6.png,13,6,391,250,446,261,55,11
cell_r13_c7.png,13,7,446,250,502,262,56,12
cell_r13_c8.png,13,8,502,250,538,262,36,12
cell_r13_c9.png,13,9,538,250,570,262,32,12
cell_r13_c10.png,13,10,570,250,627,262,57,12
cell_r13_c11.png,13,11,627,251,698,262,71,11
cell_r13_c12.png,13,12,698,251,734,262,36,11
cell_r13_c13.png,13,13,734,251,767,262,33,11
cell_r13_c14.png,13,14,767,251,822,262,55,11
cell_r13_c15.png,13,15,822,251,887,262,65,11
cell_r13_c16.png,13,16,887,252,920,262,33,10
cell_r13_c17.png,13,17,920,251,986,262,66,11
cell_r13_c18.png,13,18,986,251,1051,262,65,11
cell_r13_c0.png,13,0,1,250,16,260,15,10
cell_r13_c1.png,13,1,16,250,230,261,214,11
cell_r13_c2.png,13,2,229,250,279,261,50,11
cell_r13_c3.png,13,3,279,250,323,261,44,11
cell_r13_c4.png,13,4,323,250,359,261,36,11
cell_r13_c5.png,13,5,359,250,391,261,32,11
cell_r13_c6.png,13,6,391,250,446,261,55,11
cell_r13_c7.png,13,7,446,250,502,262,56,12
cell_r13_c8.png,13,8,502,250,538,262,36,12
cell_r13_c9.png,13,9,538,250,570,262,32,12
cell_r13_c10.png,13,10,570,250,627,262,57,12
cell_r13_c11.png,13,11,627,251,698,262,71,11
cell_r13_c12.png,13,12,698,251,734,262,36,11
cell_r13_c13.png,13,13,734,251,767,262,33,11
cell_r13_c14.png,13,14,767,251,822,262,55,11
cell_r13_c15.png,13,15,822,251,887,262,65,11
cell_r13_c16.png,13,16,887,252,920,262,33,10
cell_r13_c17.png,13,17,920,251,986,262,66,11
cell_r13_c18.png,13,18,986,251,1051,262,65,11
cell_r13_c0.png,13,0,1,250,16,260,15,10
cell_r13_c1.png,13,1,16,250,230,261,214,11
cell_r13_c2.png,13,2,229,250,279,261,50,11
cell_r13_c3.png,13,3,279,250,323,261,44,11
cell_r13_c4.png,13,4,323,250,359,261,36,11
cell_r13_c5.png,13,5,359,250,391,261,32,11
cell_r13_c6.png,13,6,391,250,446,261,55,11
cell_r13_c7.png,13,7,446,250,502,262,56,12
cell_r13_c8.png,13,8,502,250,538,262,36,12
cell_r13_c9.png,13,9,538,250,570,262,32,12
cell_r13_c10.png,13,10,570,250,627,262,57,12
cell_r13_c11.png,13,11,627,251,698,262,71,11
cell_r13_c12.png,13,12,698,251,734,262,36,11
cell_r13_c13.png,13,13,734,251,767,262,33,11
cell_r13_c14.png,13,14,767,251,822,262,55,11
cell_r13_c15.png,13,15,822,251,887,262,65,11
cell_r13_c16.png,13,16,887,252,920,262,33,10
cell_r13_c17.png,13,17,920,251,986,262,66,11
cell_r13_c18.png,13,18,986,251,1051,262,65,11
cell_r13_c0.png,13,0,1,250,16,260,15,10
cell_r13_c1.png,13,1,16,250,230,261,214,11
cell_r13_c2.png,13,2,229,250,279,261,50,11
cell_r13_c3.png,13,3,279,250,323,261,44,11
cell_r13_c4.png,13,4,323,250,359,261,36,11
cell_r13_c5.png,13,5,359,250,391,261,32,11
cell_r13_c6.png,13,6,391,250,446,261,55,11
cell_r13_c7.png,13,7,446,250,502,262,56,12
cell_r13_c8.png,13,8,502,250,538,262,36,12
cell_r13_c9.png,13,9,538,250,570,262,32,12
cell_r13_c10.png,13,10,570,250,627,262,57,12
cell_r13_c11.png,13,11,627,251,698,262,71,11
cell_r13_c12.png,13,12,698,251,734,262,36,11
cell_r13_c13.png,13,13,734,251,767,262,33,11
cell_r13_c14.png,13,14,767,251,822,262,55,11
cell_r13_c15.png,13,15,822,251,887,262,65,11
cell_r13_c16.png,13,16,887,252,920,262,33,10
cell_r13_c17.png,13,17,920,251,986,262,66,11
cell_r13_c18.png,13,18,986,251,1051,262,65,11
cell_r13_c0.png,13,0,1,250,16,260,15,10
cell_r13_c1.png,13,1,16,250,230,261,214,11
cell_r13_c2.png,13,2,229,250,279,261,50,11
cell_r13_c3.png,13,3,279,250,323,261,44,11
cell_r13_c4.png,13,4,323,250,359,261,36,11
cell_r13_c5.png,13,5,359,250,391,261,32,11
cell_r13_c6.png,13,6,391,250,446,261,55,11
cell_r13_c7.png,13,7,446,250,502,262,56,12
cell_r13_c8.png,13,8,502,250,538,262,36,12
cell_r13_c9.png,13,9,538,250,570,262,32,12
cell_r13_c10.png,13,10,570,250,627,262,57,12
cell_r13_c11.png,13,11,627,251,698,262,71,11
cell_r13_c12.png,13,12,698,251,734,262,36,11
cell_r13_c13.png,13,13,734,251,767,262,33,11
cell_r13_c14.png,13,14,767,251,822,262,55,11
cell_r13_c15.png,13,15,822,251,887,262,65,11
cell_r13_c16.png,13,16,887,252,920,262,33,10
cell_r13_c17.png,13,17,920,251,986,262,66,11
cell_r13_c18.png,13,18,986,251,1051,262,65,11
cell_r13_c0.png,13,0,1,250,16,260,15,10
cell_r13_c1.png,13,1,16,250,230,261,214,11
cell_r13_c2.png,13,2,229,250,279,261,50,11
cell_r13_c3.png,13,3,279,250,323,261,44,11
cell_r13_c4.png,13,4,323,250,359,261,36,11
cell_r13_c5.png,13,5,359,250,391,261,32,11
cell_r13_c6.png,13,6,391,250,446,261,55,11
cell_r13_c7.png,13,7,446,250,502,262,56,12
cell_r13_c8.png,13,8,502,250,538,262,36,12
cell_r13_c9.png,13,9,538,250,570,262,32,12
cell_r13_c10.png,13,10,570,250,627,262,57,12
cell_r13_c11.png,13,11,627,251,698,262,71,11
cell_r13_c12.png,13,12,698,251,734,262,36,11
cell_r13_c13.png,13,13,734,251,767,262,33,11
cell_r13_c14.png,13,14,767,251,822,262,55,11
cell_r13_c15.png,13,15,822,251,887,262,65,11
cell_r13_c16.png,13,16,887,252,920,262,33,10
cell_r13_c17.png,13,17,920,251,986,262,66,11
cell_r13_c18.png,13,18,986,251,1051,262,65,11
cell_r13_c0.png,13,0,1,250,16,260,15,10
cell_r13_c1.png,13,1,16,250,230,261,214,11
cell_r13_c2.png,13,2,229,250,279,261,50,11
cell_r13_c3.png,13,3,279,250,323,261,44,11
cell_r13_c4.png,13,4,323,250,359,261,36,11
cell_r13_c5.png,13,5,359,250,391,261,32,11
cell_r13_c6.png,13,6,391,250,446,261,55,11
cell_r13_c7.png,13,7,446,250,502,262,56,12
cell_r13_c8.png,13,8,502,250,538,262,36,12
cell_r13_c9.png,13,9,538,250,570,262,32,12
cell_r13_c10.png,13,10,570,250,627,262,57,12
cell_r13_c11.png,13,11,627,251,698,262,71,11
cell_r13_c12.png,13,12,698,251,734,262,36,11
cell_r13_c13.png,13,13,734,251,767,262,33,11
cell_r13_c14.png,13,14,767,251,822,262,55,11
cell_r13_c15.png,13,15,822,251,887,262,65,11
cell_r13_c16.png,13,16,887,252,920,262,33,10
cell_r13_c17.png,13,17,920,251,986,262,66,11
cell_r13_c18.png,13,18,986,251,1051,262,65,11
cell_r13_c0.png,13,0,1,250,16,260,15,10
cell_r13_c1.png,13,1,16,250,230,261,214,11
cell_r13_c2.png,13,2,229,250,279,261,50,11
cell_r13_c3.png,13,3,279,250,323,261,44,11
cell_r13_c4.png,13,4,323,250,359,261,36,11
cell_r13_c5.png,13,5,359,250,391,261,32,11
cell_r13_c6.png,13,6,391,250,446,261,55,11
cell_r13_c7.png,13,7,446,250,502,262,56,12
cell_r13_c8.png,13,8,502,250,538,262,36,12
cell_r13_c9.png,13,9,538,250,570,262,32,12
cell_r13_c10.png,13,10,570,250,627,262,57,12
cell_r13_c11.png,13,11,627,251,698,262,71,11
cell_r13_c12.png,13,12,698,251,734,262,36,11
cell_r13_c13.png,13,13,734,251,767,262,33,11
cell_r13_c14.png,13,14,767,251,822,262,55,11
cell_r13_c15.png,13,15,822,251,887,262,65,11
cell_r13_c16.png,13,16,887,252,920,262,33,10
cell_r13_c17.png,13,17,920,251,986,262,66,11
cell_r13_c18.png,13,18,986,251,1051,262,65,11
cell_r13_c0.png,13,0,1,250,16,260,15,10
cell_r13_c1.png,13,1,16,250,230,261,214,11
cell_r13_c2.png,13,2,229,250,279,261,50,11
cell_r13_c3.png,13,3,279,250,323,261,44,11
cell_r13_c4.png,13,4,323,250,359,261,36,11
cell_r13_c5.png,13,5,359,250,391,261,32,11
cell_r13_c6.png,13,6,391,250,446,261,55,11
cell_r13_c7.png,13,7,446,250,502,262,56,12
cell_r13_c8.png,13,8,502,250,538,262,36,12
cell_r13_c9.png,13,9,538,250,570,262,32,12
cell_r13_c10.png,13,10,570,250,627,262,57,12
cell_r13_c11.png,13,11,627,251,698,262,71,11
cell_r13_c12.png,13,12,698,251,734,262,36,11
cell_r13_c13.png,13,13,734,251,767,262,33,11
cell_r13_c14.png,13,14,767,251,822,262,55,11
cell_r13_c15.png,13,15,822,251,887,262,65,11
cell_r13_c16.png,13,16,887,252,920,262,33,10
cell_r13_c17.png,13,17,920,251,986,262,66,11
cell_r13_c18.png,13,18,986,251,1051,262,65,11
cell_r13_c0.png,13,0,1,250,16,260,15,10
cell_r13_c1.png,13,1,16,250,230,261,214,11
cell_r13_c2.png,13,2,229,250,279,261,50,11
cell_r13_c3.png,13,3,279,250,323,261,44,11
cell_r13_c4.png,13,4,323,250,359,261,36,11
cell_r13_c5.png,13,5,359,250,391,261,32,11
cell_r13_c6.png,13,6,391,250,446,261,55,11
cell_r13_c7.png,13,7,446,250,502,262,56,12
cell_r13_c8.png,13,8,502,250,538,262,36,12
cell_r13_c9.png,13,9,538,250,570,262,32,12
cell_r13_c10.png,13,10,570,250,627,262,57,12
cell_r13_c11.png,13,11,627,251,698,262,71,11
cell_r13_c12.png,13,12,698,251,734,262,36,11
cell_r13_c13.png,13,13,734,251,767,262,33,11
cell_r13_c14.png,13,14,767,251,822,262,55,11
cell_r13_c15.png,13,15,822,251,887,262,65,11
cell_r13_c16.png,13,16,887,252,920,262,33,10
cell_r13_c17.png,13,17,920,251,986,262,66,11
cell_r13_c18.png,13,18,986,251,1051,262,65,11
cell_r13_c0.png,13,0,1,250,16,260,15,10
cell_r13_c1.png,13,1,16,250,230,261,214,11
cell_r13_c2.png,13,2,229,250,279,261,50,11
cell_r13_c3.png,13,3,279,250,323,261,44,11
cell_r13_c4.png,13,4,323,250,359,261,36,11
cell_r13_c5.png,13,5,359,250,391,261,32,11
cell_r13_c6.png,13,6,391,250,446,261,55,11
cell_r13_c7.png,13,7,446,250,502,262,56,12
cell_r13_c8.png,13,8,502,250,538,262,36,12
cell_r13_c9.png,13,9,538,250,570,262,32,12
cell_r13_c10.png,13,10,570,250,627,262,57,12
cell_r13_c11.png,13,11,627,251,698,262,71,11
cell_r13_c12.png,13,12,698,251,734,262,36,11
cell_r13_c13.png,13,13,734,251,767,262,33,11
cell_r13_c14.png,13,14,767,251,822,262,55,11
cell_r13_c15.png,13,15,822,251,887,262,65,11
cell_r13_c16.png,13,16,887,252,920,262,33,10
cell_r13_c17.png,13,17,920,251,986,262,66,11
cell_r13_c18.png,13,18,986,251,1051,262,65,11
cell_r13_c0.png,13,0,1,250,16,260,15,10
cell_r13_c1.png,13,1,16,250,230,261,214,11
cell_r13_c2.png,13,2,229,250,279,261,50,11
cell_r13_c3.png,13,3,279,250,323,261,44,11
cell_r13_c4.png,13,4,323,250,359,261,36,11
cell_r13_c5.png,13,5,359,250,391,261,32,11
cell_r13_c6.png,13,6,391,250,446,261,55,11
cell_r13_c7.png,13,7,446,250,502,262,56,12
cell_r13_c8.png,13,8,502,250,538,262,36,12
cell_r13_c9.png,13,9,538,250,570,262,32,12
cell_r13_c10.png,13,10,570,250,627,262,57,12
cell_r13_c11.png,13,11,627,251,698,262,71,11
cell_r13_c12.png,13,12,698,251,734,262,36,11
cell_r13_c13.png,13,13,734,251,767,262,33,11
cell_r13_c14.png,13,14,767,251,822,262,55,11
cell_r13_c15.png,13,15,822,251,887,262,65,11
cell_r13_c16.png,13,16,887,252,920,262,33,10
cell_r13_c17.png,13,17,920,251,986,262,66,11
cell_r13_c18.png,13,18,986,251,1051,262,65,11
cell_r13_c0.png,13,0,1,250,16,260,15,10
cell_r13_c1.png,13,1,16,250,230,261,214,11
cell_r13_c2.png,13,2,229,250,279,261,50,11
cell_r13_c3.png,13,3,279,250,323,261,44,11
cell_r13_c4.png,13,4,323,250,359,261,36,11
cell_r13_c5.png,13,5,359,250,391,261,32,11
cell_r13_c6.png,13,6,391,250,446,261,55,11
cell_r13_c7.png,13,7,446,250,502,262,56,12
cell_r13_c8.png,13,8,502,250,538,262,36,12
cell_r13_c9.png,13,9,538,250,570,262,32,12
cell_r13_c10.png,13,10,570,250,627,262,57,12
cell_r13_c11.png,13,11,627,251,698,262,71,11
cell_r13_c12.png,13,12,698,251,734,262,36,11
cell_r13_c13.png,13,13,734,251,767,262,33,11
cell_r13_c14.png,13,14,767,251,822,262,55,11
cell_r13_c15.png,13,15,822,251,887,262,65,11
cell_r13_c16.png,13,16,887,252,920,262,33,10
cell_r13_c17.png,13,17,920,251,986,262,66,11
cell_r13_c18.png,13,18,986,251,1051,262,65,11
cell_r13_c0.png,13,0,1,250,16,260,15,10
cell_r13_c1.png,13,1,16,250,230,261,214,11
cell_r13_c2.png,13,2,229,250,279,261,50,11
cell_r13_c3.png,13,3,279,250,323,261,44,11
cell_r13_c4.png,13,4,323,250,359,261,36,11
cell_r13_c5.png,13,5,359,250,391,261,32,11
cell_r13_c6.png,13,6,391,250,446,261,55,11
cell_r13_c7.png,13,7,446,250,502,262,56,12
cell_r13_c8.png,13,8,502,250,538,262,36,12
cell_r13_c9.png,13,9,538,250,570,262,32,12
cell_r13_c10.png,13,10,570,250,627,262,57,12
cell_r13_c11.png,13,11,627,251,698,262,71,11
cell_r13_c12.png,13,12,698,251,734,262,36,11
cell_r13_c13.png,13,13,734,251,767,262,33,11
cell_r13_c14.png,13,14,767,251,822,262,55,11
cell_r13_c15.png,13,15,822,251,887,262,65,11
cell_r13_c16.png,13,16,887,252,920,262,33,10
cell_r13_c17.png,13,17,920,251,986,262,66,11
cell_r13_c18.png,13,18,986,251,1051,262,65,11
cell_r14_c0.png,14,0,1,260,16,271,15,11
cell_r14_c1.png,14,1,16,260,229,272,213,12
cell_r14_c2.png,14,2,229,261,279,272,50,11
cell_r14_c3.png,14,3,279,261,323,272,44,11
cell_r14_c4.png,14,4,323,261,359,272,36,11
cell_r14_c5.png,14,5,359,261,391,272,32,11
cell_r14_c6.png,14,6,391,261,446,272,55,11
cell_r14_c7.png,14,7,446,261,502,273,56,12
cell_r14_c8.png,14,8,502,262,538,273,36,11
cell_r14_c9.png,14,9,538,261,571,272,33,11
cell_r14_c10.png,14,10,570,261,627,273,57,12
cell_r14_c11.png,14,11,627,262,698,273,71,11
cell_r14_c12.png,14,12,698,262,735,273,37,11
cell_r14_c13.png,14,13,734,262,767,273,33,11
cell_r14_c14.png,14,14,767,262,822,273,55,11
cell_r14_c15.png,14,15,822,262,887,273,65,11
cell_r14_c16.png,14,16,887,262,920,273,33,11
cell_r14_c17.png,14,17,920,262,986,274,66,12
cell_r14_c18.png,14,18,986,262,1051,274,65,12
cell_r14_c0.png,14,0,1,260,16,271,15,11
cell_r14_c1.png,14,1,16,260,229,272,213,12
cell_r14_c2.png,14,2,229,261,279,272,50,11
cell_r14_c3.png,14,3,279,261,323,272,44,11
cell_r14_c4.png,14,4,323,261,359,272,36,11
cell_r14_c5.png,14,5,359,261,391,272,32,11
cell_r14_c6.png,14,6,391,261,446,272,55,11
cell_r14_c7.png,14,7,446,261,502,273,56,12
cell_r14_c8.png,14,8,502,262,538,273,36,11
cell_r14_c9.png,14,9,538,261,571,272,33,11
cell_r14_c10.png,14,10,570,261,627,273,57,12
cell_r14_c11.png,14,11,627,262,698,273,71,11
cell_r14_c12.png,14,12,698,262,735,273,37,11
cell_r14_c13.png,14,13,734,262,767,273,33,11
cell_r14_c14.png,14,14,767,262,822,273,55,11
cell_r14_c15.png,14,15,822,262,887,273,65,11
cell_r14_c16.png,14,16,887,262,920,273,33,11
cell_r14_c17.png,14,17,920,262,986,274,66,12
cell_r14_c18.png,14,18,986,262,1051,274,65,12
cell_r14_c0.png,14,0,1,260,16,271,15,11
cell_r14_c1.png,14,1,16,260,229,272,213,12
cell_r14_c2.png,14,2,229,261,279,272,50,11
cell_r14_c3.png,14,3,279,261,323,272,44,11
cell_r14_c4.png,14,4,323,261,359,272,36,11
cell_r14_c5.png,14,5,359,261,391,272,32,11
cell_r14_c6.png,14,6,391,261,446,272,55,11
cell_r14_c7.png,14,7,446,261,502,273,56,12
cell_r14_c8.png,14,8,502,262,538,273,36,11
cell_r14_c9.png,14,9,538,261,571,272,33,11
cell_r14_c10.png,14,10,570,261,627,273,57,12
cell_r14_c11.png,14,11,627,262,698,273,71,11
cell_r14_c12.png,14,12,698,262,735,273,37,11
cell_r14_c13.png,14,13,734,262,767,273,33,11
cell_r14_c14.png,14,14,767,262,822,273,55,11
cell_r14_c15.png,14,15,822,262,887,273,65,11
cell_r14_c16.png,14,16,887,262,920,273,33,11
cell_r14_c17.png,14,17,920,262,986,274,66,12
cell_r14_c18.png,14,18,986,262,1051,274,65,12
cell_r14_c0.png,14,0,1,260,16,271,15,11
cell_r14_c1.png,14,1,16,260,229,272,213,12
cell_r14_c2.png,14,2,229,261,279,272,50,11
cell_r14_c3.png,14,3,279,261,323,272,44,11
cell_r14_c4.png,14,4,323,261,359,272,36,11
cell_r14_c5.png,14,5,359,261,391,272,32,11
cell_r14_c6.png,14,6,391,261,446,272,55,11
cell_r14_c7.png,14,7,446,261,502,273,56,12
cell_r14_c8.png,14,8,502,262,538,273,36,11
cell_r14_c9.png,14,9,538,261,571,272,33,11
cell_r14_c10.png,14,10,570,261,627,273,57,12
cell_r14_c11.png,14,11,627,262,698,273,71,11
cell_r14_c12.png,14,12,698,262,735,273,37,11
cell_r14_c13.png,14,13,734,262,767,273,33,11
cell_r14_c14.png,14,14,767,262,822,273,55,11
cell_r14_c15.png,14,15,822,262,887,273,65,11
cell_r14_c16.png,14,16,887,262,920,273,33,11
cell_r14_c17.png,14,17,920,262,986,274,66,12
cell_r14_c18.png,14,18,986,262,1051,274,65,12
cell_r14_c0.png,14,0,1,260,16,271,15,11
cell_r14_c1.png,14,1,16,260,229,272,213,12
cell_r14_c2.png,14,2,229,261,279,272,50,11
cell_r14_c3.png,14,3,279,261,323,272,44,11
cell_r14_c4.png,14,4,323,261,359,272,36,11
cell_r14_c5.png,14,5,359,261,391,272,32,11
cell_r14_c6.png,14,6,391,261,446,272,55,11
cell_r14_c7.png,14,7,446,261,502,273,56,12
cell_r14_c8.png,14,8,502,262,538,273,36,11
cell_r14_c9.png,14,9,538,261,571,272,33,11
cell_r14_c10.png,14,10,570,261,627,273,57,12
cell_r14_c11.png,14,11,627,262,698,273,71,11
cell_r14_c12.png,14,12,698,262,735,273,37,11
cell_r14_c13.png,14,13,734,262,767,273,33,11
cell_r14_c14.png,14,14,767,262,822,273,55,11
cell_r14_c15.png,14,15,822,262,887,273,65,11
cell_r14_c16.png,14,16,887,262,920,273,33,11
cell_r14_c17.png,14,17,920,262,986,274,66,12
cell_r14_c18.png,14,18,986,262,1051,274,65,12
cell_r14_c0.png,14,0,1,260,16,271,15,11
cell_r14_c1.png,14,1,16,260,229,272,213,12
cell_r14_c2.png,14,2,229,261,279,272,50,11
cell_r14_c3.png,14,3,279,261,323,272,44,11
cell_r14_c4.png,14,4,323,261,359,272,36,11
cell_r14_c5.png,14,5,359,261,391,272,32,11
cell_r14_c6.png,14,6,391,261,446,272,55,11
cell_r14_c7.png,14,7,446,261,502,273,56,12
cell_r14_c8.png,14,8,502,262,538,273,36,11
cell_r14_c9.png,14,9,538,261,571,272,33,11
cell_r14_c10.png,14,10,570,261,627,273,57,12
cell_r14_c11.png,14,11,627,262,698,273,71,11
cell_r14_c12.png,14,12,698,262,735,273,37,11
cell_r14_c13.png,14,13,734,262,767,273,33,11
cell_r14_c14.png,14,14,767,262,822,273,55,11
cell_r14_c15.png,14,15,822,262,887,273,65,11
cell_r14_c16.png,14,16,887,262,920,273,33,11
cell_r14_c17.png,14,17,920,262,986,274,66,12
cell_r14_c18.png,14,18,986,262,1051,274,65,12
cell_r14_c0.png,14,0,1,260,16,271,15,11
cell_r14_c1.png,14,1,16,260,229,272,213,12
cell_r14_c2.png,14,2,229,261,279,272,50,11
cell_r14_c3.png,14,3,279,261,323,272,44,11
cell_r14_c4.png,14,4,323,261,359,272,36,11
cell_r14_c5.png,14,5,359,261,391,272,32,11
cell_r14_c6.png,14,6,391,261,446,272,55,11
cell_r14_c7.png,14,7,446,261,502,273,56,12
cell_r14_c8.png,14,8,502,262,538,273,36,11
cell_r14_c9.png,14,9,538,261,571,272,33,11
cell_r14_c10.png,14,10,570,261,627,273,57,12
cell_r14_c11.png,14,11,627,262,698,273,71,11
cell_r14_c12.png,14,12,698,262,735,273,37,11
cell_r14_c13.png,14,13,734,262,767,273,33,11
cell_r14_c14.png,14,14,767,262,822,273,55,11
cell_r14_c15.png,14,15,822,262,887,273,65,11
cell_r14_c16.png,14,16,887,262,920,273,33,11
cell_r14_c17.png,14,17,920,262,986,274,66,12
cell_r14_c18.png,14,18,986,262,1051,274,65,12
cell_r14_c0.png,14,0,1,260,16,271,15,11
cell_r14_c1.png,14,1,16,260,229,272,213,12
cell_r14_c2.png,14,2,229,261,279,272,50,11
cell_r14_c3.png,14,3,279,261,323,272,44,11
cell_r14_c4.png,14,4,323,261,359,272,36,11
cell_r14_c5.png,14,5,359,261,391,272,32,11
cell_r14_c6.png,14,6,391,261,446,272,55,11
cell_r14_c7.png,14,7,446,261,502,273,56,12
cell_r14_c8.png,14,8,502,262,538,273,36,11
cell_r14_c9.png,14,9,538,261,571,272,33,11
cell_r14_c10.png,14,10,570,261,627,273,57,12
cell_r14_c11.png,14,11,627,262,698,273,71,11
cell_r14_c12.png,14,12,698,262,735,273,37,11
cell_r14_c13.png,14,13,734,262,767,273,33,11
cell_r14_c14.png,14,14,767,262,822,273,55,11
cell_r14_c15.png,14,15,822,262,887,273,65,11
cell_r14_c16.png,14,16,887,262,920,273,33,11
cell_r14_c17.png,14,17,920,262,986,274,66,12
cell_r14_c18.png,14,18,986,262,1051,274,65,12
cell_r14_c0.png,14,0,1,260,16,271,15,11
cell_r14_c1.png,14,1,16,260,229,272,213,12
cell_r14_c2.png,14,2,229,261,279,272,50,11
cell_r14_c3.png,14,3,279,261,323,272,44,11
cell_r14_c4.png,14,4,323,261,359,272,36,11
cell_r14_c5.png,14,5,359,261,391,272,32,11
cell_r14_c6.png,14,6,391,261,446,272,55,11
cell_r14_c7.png,14,7,446,261,502,273,56,12
cell_r14_c8.png,14,8,502,262,538,273,36,11
cell_r14_c9.png,14,9,538,261,571,272,33,11
cell_r14_c10.png,14,10,570,261,627,273,57,12
cell_r14_c11.png,14,11,627,262,698,273,71,11
cell_r14_c12.png,14,12,698,262,735,273,37,11
cell_r14_c13.png,14,13,734,262,767,273,33,11
cell_r14_c14.png,14,14,767,262,822,273,55,11
cell_r14_c15.png,14,15,822,262,887,273,65,11
cell_r14_c16.png,14,16,887,262,920,273,33,11
cell_r14_c17.png,14,17,920,262,986,274,66,12
cell_r14_c18.png,14,18,986,262,1051,274,65,12
cell_r14_c0.png,14,0,1,260,16,271,15,11
cell_r14_c1.png,14,1,16,260,229,272,213,12
cell_r14_c2.png,14,2,229,261,279,272,50,11
cell_r14_c3.png,14,3,279,261,323,272,44,11
cell_r14_c4.png,14,4,323,261,359,272,36,11
cell_r14_c5.png,14,5,359,261,391,272,32,11
cell_r14_c6.png,14,6,391,261,446,272,55,11
cell_r14_c7.png,14,7,446,261,502,273,56,12
cell_r14_c8.png,14,8,502,262,538,273,36,11
cell_r14_c9.png,14,9,538,261,571,272,33,11
cell_r14_c10.png,14,10,570,261,627,273,57,12
cell_r14_c11.png,14,11,627,262,698,273,71,11
cell_r14_c12.png,14,12,698,262,735,273,37,11
cell_r14_c13.png,14,13,734,262,767,273,33,11
cell_r14_c14.png,14,14,767,262,822,273,55,11
cell_r14_c15.png,14,15,822,262,887,273,65,11
cell_r14_c16.png,14,16,887,262,920,273,33,11
cell_r14_c17.png,14,17,920,262,986,274,66,12
cell_r14_c18.png,14,18,986,262,1051,274,65,12
cell_r14_c0.png,14,0,1,260,16,271,15,11
cell_r14_c1.png,14,1,16,260,229,272,213,12
cell_r14_c2.png,14,2,229,261,279,272,50,11
cell_r14_c3.png,14,3,279,261,323,272,44,11
cell_r14_c4.png,14,4,323,261,359,272,36,11
cell_r14_c5.png,14,5,359,261,391,272,32,11
cell_r14_c6.png,14,6,391,261,446,272,55,11
cell_r14_c7.png,14,7,446,261,502,273,56,12
cell_r14_c8.png,14,8,502,262,538,273,36,11
cell_r14_c9.png,14,9,538,261,571,272,33,11
cell_r14_c10.png,14,10,570,261,627,273,57,12
cell_r14_c11.png,14,11,627,262,698,273,71,11
cell_r14_c12.png,14,12,698,262,735,273,37,11
cell_r14_c13.png,14,13,734,262,767,273,33,11
cell_r14_c14.png,14,14,767,262,822,273,55,11
cell_r14_c15.png,14,15,822,262,887,273,65,11
cell_r14_c16.png,14,16,887,262,920,273,33,11
cell_r14_c17.png,14,17,920,262,986,274,66,12
cell_r14_c18.png,14,18,986,262,1051,274,65,12
cell_r14_c0.png,14,0,1,260,16,271,15,11
cell_r14_c1.png,14,1,16,260,229,272,213,12
cell_r14_c2.png,14,2,229,261,279,272,50,11
cell_r14_c3.png,14,3,279,261,323,272,44,11
cell_r14_c4.png,14,4,323,261,359,272,36,11
cell_r14_c5.png,14,5,359,261,391,272,32,11
cell_r14_c6.png,14,6,391,261,446,272,55,11
cell_r14_c7.png,14,7,446,261,502,273,56,12
cell_r14_c8.png,14,8,502,262,538,273,36,11
cell_r14_c9.png,14,9,538,261,571,272,33,11
cell_r14_c10.png,14,10,570,261,627,273,57,12
cell_r14_c11.png,14,11,627,262,698,273,71,11
cell_r14_c12.png,14,12,698,262,735,273,37,11
cell_r14_c13.png,14,13,734,262,767,273,33,11
cell_r14_c14.png,14,14,767,262,822,273,55,11
cell_r14_c15.png,14,15,822,262,887,273,65,11
cell_r14_c16.png,14,16,887,262,920,273,33,11
cell_r14_c17.png,14,17,920,262,986,274,66,12
cell_r14_c18.png,14,18,986,262,1051,274,65,12
cell_r14_c0.png,14,0,1,260,16,271,15,11
cell_r14_c1.png,14,1,16,260,229,272,213,12
cell_r14_c2.png,14,2,229,261,279,272,50,11
cell_r14_c3.png,14,3,279,261,323,272,44,11
cell_r14_c4.png,14,4,323,261,359,272,36,11
cell_r14_c5.png,14,5,359,261,391,272,32,11
cell_r14_c6.png,14,6,391,261,446,272,55,11
cell_r14_c7.png,14,7,446,261,502,273,56,12
cell_r14_c8.png,14,8,502,262,538,273,36,11
cell_r14_c9.png,14,9,538,261,571,272,33,11
cell_r14_c10.png,14,10,570,261,627,273,57,12
cell_r14_c11.png,14,11,627,262,698,273,71,11
cell_r14_c12.png,14,12,698,262,735,273,37,11
cell_r14_c13.png,14,13,734,262,767,273,33,11
cell_r14_c14.png,14,14,767,262,822,273,55,11
cell_r14_c15.png,14,15,822,262,887,273,65,11
cell_r14_c16.png,14,16,887,262,920,273,33,11
cell_r14_c17.png,14,17,920,262,986,274,66,12
cell_r14_c18.png,14,18,986,262,1051,274,65,12
cell_r14_c0.png,14,0,1,260,16,271,15,11
cell_r14_c1.png,14,1,16,260,229,272,213,12
cell_r14_c2.png,14,2,229,261,279,272,50,11
cell_r14_c3.png,14,3,279,261,323,272,44,11
cell_r14_c4.png,14,4,323,261,359,272,36,11
cell_r14_c5.png,14,5,359,261,391,272,32,11
cell_r14_c6.png,14,6,391,261,446,272,55,11
cell_r14_c7.png,14,7,446,261,502,273,56,12
cell_r14_c8.png,14,8,502,262,538,273,36,11
cell_r14_c9.png,14,9,538,261,571,272,33,11
cell_r14_c10.png,14,10,570,261,627,273,57,12
cell_r14_c11.png,14,11,627,262,698,273,71,11
cell_r14_c12.png,14,12,698,262,735,273,37,11
cell_r14_c13.png,14,13,734,262,767,273,33,11
cell_r14_c14.png,14,14,767,262,822,273,55,11
cell_r14_c15.png,14,15,822,262,887,273,65,11
cell_r14_c16.png,14,16,887,262,920,273,33,11
cell_r14_c17.png,14,17,920,262,986,274,66,12
cell_r14_c18.png,14,18,986,262,1051,274,65,12
cell_r14_c0.png,14,0,1,260,16,271,15,11
cell_r14_c1.png,14,1,16,260,229,272,213,12
cell_r14_c2.png,14,2,229,261,279,272,50,11
cell_r14_c3.png,14,3,279,261,323,272,44,11
cell_r14_c4.png,14,4,323,261,359,272,36,11
cell_r14_c5.png,14,5,359,261,391,272,32,11
cell_r14_c6.png,14,6,391,261,446,272,55,11
cell_r14_c7.png,14,7,446,261,502,273,56,12
cell_r14_c8.png,14,8,502,262,538,273,36,11
cell_r14_c9.png,14,9,538,261,571,272,33,11
cell_r14_c10.png,14,10,570,261,627,273,57,12
cell_r14_c11.png,14,11,627,262,698,273,71,11
cell_r14_c12.png,14,12,698,262,735,273,37,11
cell_r14_c13.png,14,13,734,262,767,273,33,11
cell_r14_c14.png,14,14,767,262,822,273,55,11
cell_r14_c15.png,14,15,822,262,887,273,65,11
cell_r14_c16.png,14,16,887,262,920,273,33,11
cell_r14_c17.png,14,17,920,262,986,274,66,12
cell_r14_c18.png,14,18,986,262,1051,274,65,12
cell_r14_c0.png,14,0,1,260,16,271,15,11
cell_r14_c1.png,14,1,16,260,229,272,213,12
cell_r14_c2.png,14,2,229,261,279,272,50,11
cell_r14_c3.png,14,3,279,261,323,272,44,11
cell_r14_c4.png,14,4,323,261,359,272,36,11
cell_r14_c5.png,14,5,359,261,391,272,32,11
cell_r14_c6.png,14,6,391,261,446,272,55,11
cell_r14_c7.png,14,7,446,261,502,273,56,12
cell_r14_c8.png,14,8,502,262,538,273,36,11
cell_r14_c9.png,14,9,538,261,571,272,33,11
cell_r14_c10.png,14,10,570,261,627,273,57,12
cell_r14_c11.png,14,11,627,262,698,273,71,11
cell_r14_c12.png,14,12,698,262,735,273,37,11
cell_r14_c13.png,14,13,734,262,767,273,33,11
cell_r14_c14.png,14,14,767,262,822,273,55,11
cell_r14_c15.png,14,15,822,262,887,273,65,11
cell_r14_c16.png,14,16,887,262,920,273,33,11
cell_r14_c17.png,14,17,920,262,986,274,66,12
cell_r14_c18.png,14,18,986,262,1051,274,65,12
cell_r14_c0.png,14,0,1,260,16,271,15,11
cell_r14_c1.png,14,1,16,260,229,272,213,12
cell_r14_c2.png,14,2,229,261,279,272,50,11
cell_r14_c3.png,14,3,279,261,323,272,44,11
cell_r14_c4.png,14,4,323,261,359,272,36,11
cell_r14_c5.png,14,5,359,261,391,272,32,11
cell_r14_c6.png,14,6,391,261,446,272,55,11
cell_r14_c7.png,14,7,446,261,502,273,56,12
cell_r14_c8.png,14,8,502,262,538,273,36,11
cell_r14_c9.png,14,9,538,261,571,272,33,11
cell_r14_c10.png,14,10,570,261,627,273,57,12
cell_r14_c11.png,14,11,627,262,698,273,71,11
cell_r14_c12.png,14,12,698,262,735,273,37,11
cell_r14_c13.png,14,13,734,262,767,273,33,11
cell_r14_c14.png,14,14,767,262,822,273,55,11
cell_r14_c15.png,14,15,822,262,887,273,65,11
cell_r14_c16.png,14,16,887,262,920,273,33,11
cell_r14_c17.png,14,17,920,262,986,274,66,12
cell_r14_c18.png,14,18,986,262,1051,274,65,12
cell_r14_c0.png,14,0,1,260,16,271,15,11
cell_r14_c1.png,14,1,16,260,229,272,213,12
cell_r14_c2.png,14,2,229,261,279,272,50,11
cell_r14_c3.png,14,3,279,261,323,272,44,11
cell_r14_c4.png,14,4,323,261,359,272,36,11
cell_r14_c5.png,14,5,359,261,391,272,32,11
cell_r14_c6.png,14,6,391,261,446,272,55,11
cell_r14_c7.png,14,7,446,261,502,273,56,12
cell_r14_c8.png,14,8,502,262,538,273,36,11
cell_r14_c9.png,14,9,538,261,571,272,33,11
cell_r14_c10.png,14,10,570,261,627,273,57,12
cell_r14_c11.png,14,11,627,262,698,273,71,11
cell_r14_c12.png,14,12,698,262,735,273,37,11
cell_r14_c13.png,14,13,734,262,767,273,33,11
cell_r14_c14.png,14,14,767,262,822,273,55,11
cell_r14_c15.png,14,15,822,262,887,273,65,11
cell_r14_c16.png,14,16,887,262,920,273,33,11
cell_r14_c17.png,14,17,920,262,986,274,66,12
cell_r14_c18.png,14,18,986,262,1051,274,65,12
cell_r14_c0.png,14,0,1,260,16,271,15,11
cell_r14_c1.png,14,1,16,260,229,272,213,12
cell_r14_c2.png,14,2,229,261,279,272,50,11
cell_r14_c3.png,14,3,279,261,323,272,44,11
cell_r14_c4.png,14,4,323,261,359,272,36,11
cell_r14_c5.png,14,5,359,261,391,272,32,11
cell_r14_c6.png,14,6,391,261,446,272,55,11
cell_r14_c7.png,14,7,446,261,502,273,56,12
cell_r14_c8.png,14,8,502,262,538,273,36,11
cell_r14_c9.png,14,9,538,261,571,272,33,11
cell_r14_c10.png,14,10,570,261,627,273,57,12
cell_r14_c11.png,14,11,627,262,698,273,71,11
cell_r14_c12.png,14,12,698,262,735,273,37,11
cell_r14_c13.png,14,13,734,262,767,273,33,11
cell_r14_c14.png,14,14,767,262,822,273,55,11
cell_r14_c15.png,14,15,822,262,887,273,65,11
cell_r14_c16.png,14,16,887,262,920,273,33,11
cell_r14_c17.png,14,17,920,262,986,274,66,12
cell_r14_c18.png,14,18,986,262,1051,274,65,12
cell_r15_c0.png,15,0,1,271,16,282,15,11
cell_r15_c1.png,15,1,16,271,229,283,213,12
cell_r15_c2.png,15,2,229,272,279,283,50,11
cell_r15_c3.png,15,3,279,272,323,283,44,11
cell_r15_c4.png,15,4,323,272,359,283,36,11
cell_r15_c5.png,15,5,359,272,391,283,32,11
cell_r15_c6.png,15,6,391,272,446,283,55,11
cell_r15_c7.png,15,7,446,272,502,284,56,12
cell_r15_c8.png,15,8,502,272,538,284,36,12
cell_r15_c9.png,15,9,538,272,571,284,33,12
cell_r15_c10.png,15,10,571,272,627,284,56,12
cell_r15_c11.png,15,11,627,273,698,284,71,11
cell_r15_c12.png,15,12,698,273,735,284,37,11
cell_r15_c13.png,15,13,735,273,767,284,32,11
cell_r15_c14.png,15,14,767,273,823,284,56,11
cell_r15_c15.png,15,15,822,273,888,284,66,11
cell_r15_c16.png,15,16,887,273,920,284,33,11
cell_r15_c17.png,15,17,920,273,986,284,66,11
cell_r15_c18.png,15,18,986,273,1051,285,65,12
cell_r15_c0.png,15,0,1,271,16,282,15,11
cell_r15_c1.png,15,1,16,271,229,283,213,12
cell_r15_c2.png,15,2,229,272,279,283,50,11
cell_r15_c3.png,15,3,279,272,323,283,44,11
cell_r15_c4.png,15,4,323,272,359,283,36,11
cell_r15_c5.png,15,5,359,272,391,283,32,11
cell_r15_c6.png,15,6,391,272,446,283,55,11
cell_r15_c7.png,15,7,446,272,502,284,56,12
cell_r15_c8.png,15,8,502,272,538,284,36,12
cell_r15_c9.png,15,9,538,272,571,284,33,12
cell_r15_c10.png,15,10,571,272,627,284,56,12
cell_r15_c11.png,15,11,627,273,698,284,71,11
cell_r15_c12.png,15,12,698,273,735,284,37,11
cell_r15_c13.png,15,13,735,273,767,284,32,11
cell_r15_c14.png,15,14,767,273,823,284,56,11
cell_r15_c15.png,15,15,822,273,888,284,66,11
cell_r15_c16.png,15,16,887,273,920,284,33,11
cell_r15_c17.png,15,17,920,273,986,284,66,11
cell_r15_c18.png,15,18,986,273,1051,285,65,12
cell_r15_c0.png,15,0,1,271,16,282,15,11
cell_r15_c1.png,15,1,16,271,229,283,213,12
cell_r15_c2.png,15,2,229,272,279,283,50,11
cell_r15_c3.png,15,3,279,272,323,283,44,11
cell_r15_c4.png,15,4,323,272,359,283,36,11
cell_r15_c5.png,15,5,359,272,391,283,32,11
cell_r15_c6.png,15,6,391,272,446,283,55,11
cell_r15_c7.png,15,7,446,272,502,284,56,12
cell_r15_c8.png,15,8,502,272,538,284,36,12
cell_r15_c9.png,15,9,538,272,571,284,33,12
cell_r15_c10.png,15,10,571,272,627,284,56,12
cell_r15_c11.png,15,11,627,273,698,284,71,11
cell_r15_c12.png,15,12,698,273,735,284,37,11
cell_r15_c13.png,15,13,735,273,767,284,32,11
cell_r15_c14.png,15,14,767,273,823,284,56,11
cell_r15_c15.png,15,15,822,273,888,284,66,11
cell_r15_c16.png,15,16,887,273,920,284,33,11
cell_r15_c17.png,15,17,920,273,986,284,66,11
cell_r15_c18.png,15,18,986,273,1051,285,65,12
cell_r15_c0.png,15,0,1,271,16,282,15,11
cell_r15_c1.png,15,1,16,271,229,283,213,12
cell_r15_c2.png,15,2,229,272,279,283,50,11
cell_r15_c3.png,15,3,279,272,323,283,44,11
cell_r15_c4.png,15,4,323,272,359,283,36,11
cell_r15_c5.png,15,5,359,272,391,283,32,11
cell_r15_c6.png,15,6,391,272,446,283,55,11
cell_r15_c7.png,15,7,446,272,502,284,56,12
cell_r15_c8.png,15,8,502,272,538,284,36,12
cell_r15_c9.png,15,9,538,272,571,284,33,12
cell_r15_c10.png,15,10,571,272,627,284,56,12
cell_r15_c11.png,15,11,627,273,698,284,71,11
cell_r15_c12.png,15,12,698,273,735,284,37,11
cell_r15_c13.png,15,13,735,273,767,284,32,11
cell_r15_c14.png,15,14,767,273,823,284,56,11
cell_r15_c15.png,15,15,822,273,888,284,66,11
cell_r15_c16.png,15,16,887,273,920,284,33,11
cell_r15_c17.png,15,17,920,273,986,284,66,11
cell_r15_c18.png,15,18,986,273,1051,285,65,12
cell_r15_c0.png,15,0,1,271,16,282,15,11
cell_r15_c1.png,15,1,16,271,229,283,213,12
cell_r15_c2.png,15,2,229,272,279,283,50,11
cell_r15_c3.png,15,3,279,272,323,283,44,11
cell_r15_c4.png,15,4,323,272,359,283,36,11
cell_r15_c5.png,15,5,359,272,391,283,32,11
cell_r15_c6.png,15,6,391,272,446,283,55,11
cell_r15_c7.png,15,7,446,272,502,284,56,12
cell_r15_c8.png,15,8,502,272,538,284,36,12
cell_r15_c9.png,15,9,538,272,571,284,33,12
cell_r15_c10.png,15,10,571,272,627,284,56,12
cell_r15_c11.png,15,11,627,273,698,284,71,11
cell_r15_c12.png,15,12,698,273,735,284,37,11
cell_r15_c13.png,15,13,735,273,767,284,32,11
cell_r15_c14.png,15,14,767,273,823,284,56,11
cell_r15_c15.png,15,15,822,273,888,284,66,11
cell_r15_c16.png,15,16,887,273,920,284,33,11
cell_r15_c17.png,15,17,920,273,986,284,66,11
cell_r15_c18.png,15,18,986,273,1051,285,65,12
cell_r15_c0.png,15,0,1,271,16,282,15,11
cell_r15_c1.png,15,1,16,271,229,283,213,12
cell_r15_c2.png,15,2,229,272,279,283,50,11
cell_r15_c3.png,15,3,279,272,323,283,44,11
cell_r15_c4.png,15,4,323,272,359,283,36,11
cell_r15_c5.png,15,5,359,272,391,283,32,11
cell_r15_c6.png,15,6,391,272,446,283,55,11
cell_r15_c7.png,15,7,446,272,502,284,56,12
cell_r15_c8.png,15,8,502,272,538,284,36,12
cell_r15_c9.png,15,9,538,272,571,284,33,12
cell_r15_c10.png,15,10,571,272,627,284,56,12
cell_r15_c11.png,15,11,627,273,698,284,71,11
cell_r15_c12.png,15,12,698,273,735,284,37,11
cell_r15_c13.png,15,13,735,273,767,284,32,11
cell_r15_c14.png,15,14,767,273,823,284,56,11
cell_r15_c15.png,15,15,822,273,888,284,66,11
cell_r15_c16.png,15,16,887,273,920,284,33,11
cell_r15_c17.png,15,17,920,273,986,284,66,11
cell_r15_c18.png,15,18,986,273,1051,285,65,12
cell_r15_c0.png,15,0,1,271,16,282,15,11
cell_r15_c1.png,15,1,16,271,229,283,213,12
cell_r15_c2.png,15,2,229,272,279,283,50,11
cell_r15_c3.png,15,3,279,272,323,283,44,11
cell_r15_c4.png,15,4,323,272,359,283,36,11
cell_r15_c5.png,15,5,359,272,391,283,32,11
cell_r15_c6.png,15,6,391,272,446,283,55,11
cell_r15_c7.png,15,7,446,272,502,284,56,12
cell_r15_c8.png,15,8,502,272,538,284,36,12
cell_r15_c9.png,15,9,538,272,571,284,33,12
cell_r15_c10.png,15,10,571,272,627,284,56,12
cell_r15_c11.png,15,11,627,273,698,284,71,11
cell_r15_c12.png,15,12,698,273,735,284,37,11
cell_r15_c13.png,15,13,735,273,767,284,32,11
cell_r15_c14.png,15,14,767,273,823,284,56,11
cell_r15_c15.png,15,15,822,273,888,284,66,11
cell_r15_c16.png,15,16,887,273,920,284,33,11
cell_r15_c17.png,15,17,920,273,986,284,66,11
cell_r15_c18.png,15,18,986,273,1051,285,65,12
cell_r15_c0.png,15,0,1,271,16,282,15,11
cell_r15_c1.png,15,1,16,271,229,283,213,12
cell_r15_c2.png,15,2,229,272,279,283,50,11
cell_r15_c3.png,15,3,279,272,323,283,44,11
cell_r15_c4.png,15,4,323,272,359,283,36,11
cell_r15_c5.png,15,5,359,272,391,283,32,11
cell_r15_c6.png,15,6,391,272,446,283,55,11
cell_r15_c7.png,15,7,446,272,502,284,56,12
cell_r15_c8.png,15,8,502,272,538,284,36,12
cell_r15_c9.png,15,9,538,272,571,284,33,12
cell_r15_c10.png,15,10,571,272,627,284,56,12
cell_r15_c11.png,15,11,627,273,698,284,71,11
cell_r15_c12.png,15,12,698,273,735,284,37,11
cell_r15_c13.png,15,13,735,273,767,284,32,11
cell_r15_c14.png,15,14,767,273,823,284,56,11
cell_r15_c15.png,15,15,822,273,888,284,66,11
cell_r15_c16.png,15,16,887,273,920,284,33,11
cell_r15_c17.png,15,17,920,273,986,284,66,11
cell_r15_c18.png,15,18,986,273,1051,285,65,12
cell_r15_c0.png,15,0,1,271,16,282,15,11
cell_r15_c1.png,15,1,16,271,229,283,213,12
cell_r15_c2.png,15,2,229,272,279,283,50,11
cell_r15_c3.png,15,3,279,272,323,283,44,11
cell_r15_c4.png,15,4,323,272,359,283,36,11
cell_r15_c5.png,15,5,359,272,391,283,32,11
cell_r15_c6.png,15,6,391,272,446,283,55,11
cell_r15_c7.png,15,7,446,272,502,284,56,12
cell_r15_c8.png,15,8,502,272,538,284,36,12
cell_r15_c9.png,15,9,538,272,571,284,33,12
cell_r15_c10.png,15,10,571,272,627,284,56,12
cell_r15_c11.png,15,11,627,273,698,284,71,11
cell_r15_c12.png,15,12,698,273,735,284,37,11
cell_r15_c13.png,15,13,735,273,767,284,32,11
cell_r15_c14.png,15,14,767,273,823,284,56,11
cell_r15_c15.png,15,15,822,273,888,284,66,11
cell_r15_c16.png,15,16,887,273,920,284,33,11
cell_r15_c17.png,15,17,920,273,986,284,66,11
cell_r15_c18.png,15,18,986,273,1051,285,65,12
cell_r15_c0.png,15,0,1,271,16,282,15,11
cell_r15_c1.png,15,1,16,271,229,283,213,12
cell_r15_c2.png,15,2,229,272,279,283,50,11
cell_r15_c3.png,15,3,279,272,323,283,44,11
cell_r15_c4.png,15,4,323,272,359,283,36,11
cell_r15_c5.png,15,5,359,272,391,283,32,11
cell_r15_c6.png,15,6,391,272,446,283,55,11
cell_r15_c7.png,15,7,446,272,502,284,56,12
cell_r15_c8.png,15,8,502,272,538,284,36,12
cell_r15_c9.png,15,9,538,272,571,284,33,12
cell_r15_c10.png,15,10,571,272,627,284,56,12
cell_r15_c11.png,15,11,627,273,698,284,71,11
cell_r15_c12.png,15,12,698,273,735,284,37,11
cell_r15_c13.png,15,13,735,273,767,284,32,11
cell_r15_c14.png,15,14,767,273,823,284,56,11
cell_r15_c15.png,15,15,822,273,888,284,66,11
cell_r15_c16.png,15,16,887,273,920,284,33,11
cell_r15_c17.png,15,17,920,273,986,284,66,11
cell_r15_c18.png,15,18,986,273,1051,285,65,12
cell_r15_c0.png,15,0,1,271,16,282,15,11
cell_r15_c1.png,15,1,16,271,229,283,213,12
cell_r15_c2.png,15,2,229,272,279,283,50,11
cell_r15_c3.png,15,3,279,272,323,283,44,11
cell_r15_c4.png,15,4,323,272,359,283,36,11
cell_r15_c5.png,15,5,359,272,391,283,32,11
cell_r15_c6.png,15,6,391,272,446,283,55,11
cell_r15_c7.png,15,7,446,272,502,284,56,12
cell_r15_c8.png,15,8,502,272,538,284,36,12
cell_r15_c9.png,15,9,538,272,571,284,33,12
cell_r15_c10.png,15,10,571,272,627,284,56,12
cell_r15_c11.png,15,11,627,273,698,284,71,11
cell_r15_c12.png,15,12,698,273,735,284,37,11
cell_r15_c13.png,15,13,735,273,767,284,32,11
cell_r15_c14.png,15,14,767,273,823,284,56,11
cell_r15_c15.png,15,15,822,273,888,284,66,11
cell_r15_c16.png,15,16,887,273,920,284,33,11
cell_r15_c17.png,15,17,920,273,986,284,66,11
cell_r15_c18.png,15,18,986,273,1051,285,65,12
cell_r15_c0.png,15,0,1,271,16,282,15,11
cell_r15_c1.png,15,1,16,271,229,283,213,12
cell_r15_c2.png,15,2,229,272,279,283,50,11
cell_r15_c3.png,15,3,279,272,323,283,44,11
cell_r15_c4.png,15,4,323,272,359,283,36,11
cell_r15_c5.png,15,5,359,272,391,283,32,11
cell_r15_c6.png,15,6,391,272,446,283,55,11
cell_r15_c7.png,15,7,446,272,502,284,56,12
cell_r15_c8.png,15,8,502,272,538,284,36,12
cell_r15_c9.png,15,9,538,272,571,284,33,12
cell_r15_c10.png,15,10,571,272,627,284,56,12
cell_r15_c11.png,15,11,627,273,698,284,71,11
cell_r15_c12.png,15,12,698,273,735,284,37,11
cell_r15_c13.png,15,13,735,273,767,284,32,11
cell_r15_c14.png,15,14,767,273,823,284,56,11
cell_r15_c15.png,15,15,822,273,888,284,66,11
cell_r15_c16.png,15,16,887,273,920,284,33,11
cell_r15_c17.png,15,17,920,273,986,284,66,11
cell_r15_c18.png,15,18,986,273,1051,285,65,12
cell_r15_c0.png,15,0,1,271,16,282,15,11
cell_r15_c1.png,15,1,16,271,229,283,213,12
cell_r15_c2.png,15,2,229,272,279,283,50,11
cell_r15_c3.png,15,3,279,272,323,283,44,11
cell_r15_c4.png,15,4,323,272,359,283,36,11
cell_r15_c5.png,15,5,359,272,391,283,32,11
cell_r15_c6.png,15,6,391,272,446,283,55,11
cell_r15_c7.png,15,7,446,272,502,284,56,12
cell_r15_c8.png,15,8,502,272,538,284,36,12
cell_r15_c9.png,15,9,538,272,571,284,33,12
cell_r15_c10.png,15,10,571,272,627,284,56,12
cell_r15_c11.png,15,11,627,273,698,284,71,11
cell_r15_c12.png,15,12,698,273,735,284,37,11
cell_r15_c13.png,15,13,735,273,767,284,32,11
cell_r15_c14.png,15,14,767,273,823,284,56,11
cell_r15_c15.png,15,15,822,273,888,284,66,11
cell_r15_c16.png,15,16,887,273,920,284,33,11
cell_r15_c17.png,15,17,920,273,986,284,66,11
cell_r15_c18.png,15,18,986,273,1051,285,65,12
cell_r15_c0.png,15,0,1,271,16,282,15,11
cell_r15_c1.png,15,1,16,271,229,283,213,12
cell_r15_c2.png,15,2,229,272,279,283,50,11
cell_r15_c3.png,15,3,279,272,323,283,44,11
cell_r15_c4.png,15,4,323,272,359,283,36,11
cell_r15_c5.png,15,5,359,272,391,283,32,11
cell_r15_c6.png,15,6,391,272,446,283,55,11
cell_r15_c7.png,15,7,446,272,502,284,56,12
cell_r15_c8.png,15,8,502,272,538,284,36,12
cell_r15_c9.png,15,9,538,272,571,284,33,12
cell_r15_c10.png,15,10,571,272,627,284,56,12
cell_r15_c11.png,15,11,627,273,698,284,71,11
cell_r15_c12.png,15,12,698,273,735,284,37,11
cell_r15_c13.png,15,13,735,273,767,284,32,11
cell_r15_c14.png,15,14,767,273,823,284,56,11
cell_r15_c15.png,15,15,822,273,888,284,66,11
cell_r15_c16.png,15,16,887,273,920,284,33,11
cell_r15_c17.png,15,17,920,273,986,284,66,11
cell_r15_c18.png,15,18,986,273,1051,285,65,12
cell_r15_c0.png,15,0,1,271,16,282,15,11
cell_r15_c1.png,15,1,16,271,229,283,213,12
cell_r15_c2.png,15,2,229,272,279,283,50,11
cell_r15_c3.png,15,3,279,272,323,283,44,11
cell_r15_c4.png,15,4,323,272,359,283,36,11
cell_r15_c5.png,15,5,359,272,391,283,32,11
cell_r15_c6.png,15,6,391,272,446,283,55,11
cell_r15_c7.png,15,7,446,272,502,284,56,12
cell_r15_c8.png,15,8,502,272,538,284,36,12
cell_r15_c9.png,15,9,538,272,571,284,33,12
cell_r15_c10.png,15,10,571,272,627,284,56,12
cell_r15_c11.png,15,11,627,273,698,284,71,11
cell_r15_c12.png,15,12,698,273,735,284,37,11
cell_r15_c13.png,15,13,735,273,767,284,32,11
cell_r15_c14.png,15,14,767,273,823,284,56,11
cell_r15_c15.png,15,15,822,273,888,284,66,11
cell_r15_c16.png,15,16,887,273,920,284,33,11
cell_r15_c17.png,15,17,920,273,986,284,66,11
cell_r15_c18.png,15,18,986,273,1051,285,65,12
cell_r15_c0.png,15,0,1,271,16,282,15,11
cell_r15_c1.png,15,1,16,271,229,283,213,12
cell_r15_c2.png,15,2,229,272,279,283,50,11
cell_r15_c3.png,15,3,279,272,323,283,44,11
cell_r15_c4.png,15,4,323,272,359,283,36,11
cell_r15_c5.png,15,5,359,272,391,283,32,11
cell_r15_c6.png,15,6,391,272,446,283,55,11
cell_r15_c7.png,15,7,446,272,502,284,56,12
cell_r15_c8.png,15,8,502,272,538,284,36,12
cell_r15_c9.png,15,9,538,272,571,284,33,12
cell_r15_c10.png,15,10,571,272,627,284,56,12
cell_r15_c11.png,15,11,627,273,698,284,71,11
cell_r15_c12.png,15,12,698,273,735,284,37,11
cell_r15_c13.png,15,13,735,273,767,284,32,11
cell_r15_c14.png,15,14,767,273,823,284,56,11
cell_r15_c15.png,15,15,822,273,888,284,66,11
cell_r15_c16.png,15,16,887,273,920,284,33,11
cell_r15_c17.png,15,17,920,273,986,284,66,11
cell_r15_c18.png,15,18,986,273,1051,285,65,12
cell_r15_c0.png,15,0,1,271,16,282,15,11
cell_r15_c1.png,15,1,16,271,229,283,213,12
cell_r15_c2.png,15,2,229,272,279,283,50,11
cell_r15_c3.png,15,3,279,272,323,283,44,11
cell_r15_c4.png,15,4,323,272,359,283,36,11
cell_r15_c5.png,15,5,359,272,391,283,32,11
cell_r15_c6.png,15,6,391,272,446,283,55,11
cell_r15_c7.png,15,7,446,272,502,284,56,12
cell_r15_c8.png,15,8,502,272,538,284,36,12
cell_r15_c9.png,15,9,538,272,571,284,33,12
cell_r15_c10.png,15,10,571,272,627,284,56,12
cell_r15_c11.png,15,11,627,273,698,284,71,11
cell_r15_c12.png,15,12,698,273,735,284,37,11
cell_r15_c13.png,15,13,735,273,767,284,32,11
cell_r15_c14.png,15,14,767,273,823,284,56,11
cell_r15_c15.png,15,15,822,273,888,284,66,11
cell_r15_c16.png,15,16,887,273,920,284,33,11
cell_r15_c17.png,15,17,920,273,986,284,66,11
cell_r15_c18.png,15,18,986,273,1051,285,65,12
cell_r15_c0.png,15,0,1,271,16,282,15,11
cell_r15_c1.png,15,1,16,271,229,283,213,12
cell_r15_c2.png,15,2,229,272,279,283,50,11
cell_r15_c3.png,15,3,279,272,323,283,44,11
cell_r15_c4.png,15,4,323,272,359,283,36,11
cell_r15_c5.png,15,5,359,272,391,283,32,11
cell_r15_c6.png,15,6,391,272,446,283,55,11
cell_r15_c7.png,15,7,446,272,502,284,56,12
cell_r15_c8.png,15,8,502,272,538,284,36,12
cell_r15_c9.png,15,9,538,272,571,284,33,12
cell_r15_c10.png,15,10,571,272,627,284,56,12
cell_r15_c11.png,15,11,627,273,698,284,71,11
cell_r15_c12.png,15,12,698,273,735,284,37,11
cell_r15_c13.png,15,13,735,273,767,284,32,11
cell_r15_c14.png,15,14,767,273,823,284,56,11
cell_r15_c15.png,15,15,822,273,888,284,66,11
cell_r15_c16.png,15,16,887,273,920,284,33,11
cell_r15_c17.png,15,17,920,273,986,284,66,11
cell_r15_c18.png,15,18,986,273,1051,285,65,12
cell_r15_c0.png,15,0,1,271,16,282,15,11
cell_r15_c1.png,15,1,16,271,229,283,213,12
cell_r15_c2.png,15,2,229,272,279,283,50,11
cell_r15_c3.png,15,3,279,272,323,283,44,11
cell_r15_c4.png,15,4,323,272,359,283,36,11
cell_r15_c5.png,15,5,359,272,391,283,32,11
cell_r15_c6.png,15,6,391,272,446,283,55,11
cell_r15_c7.png,15,7,446,272,502,284,56,12
cell_r15_c8.png,15,8,502,272,538,284,36,12
cell_r15_c9.png,15,9,538,272,571,284,33,12
cell_r15_c10.png,15,10,571,272,627,284,56,12
cell_r15_c11.png,15,11,627,273,698,284,71,11
cell_r15_c12.png,15,12,698,273,735,284,37,11
cell_r15_c13.png,15,13,735,273,767,284,32,11
cell_r15_c14.png,15,14,767,273,823,284,56,11
cell_r15_c15.png,15,15,822,273,888,284,66,11
cell_r15_c16.png,15,16,887,273,920,284,33,11
cell_r15_c17.png,15,17,920,273,986,284,66,11
cell_r15_c18.png,15,18,986,273,1051,285,65,12
cell_r16_c0.png,16,0,1,282,16,299,15,17
cell_r16_c1.png,16,1,16,282,229,299,213,17
cell_r16_c2.png,16,2,228,283,279,300,51,17
cell_r16_c3.png,16,3,279,283,323,300,44,17
cell_r16_c4.png,16,4,323,283,359,300,36,17
cell_r16_c5.png,16,5,359,283,391,300,32,17
cell_r16_c6.png,16,6,391,283,446,300,55,17
cell_r16_c7.png,16,7,446,283,502,300,56,17
cell_r16_c8.png,16,8,502,284,538,300,36,16
cell_r16_c9.png,16,9,538,284,571,300,33,16
cell_r16_c10.png,16,10,570,284,627,300,57,16
cell_r16_c11.png,16,11,627,284,698,300,71,16
cell_r16_c12.png,16,12,698,284,735,300,37,16
cell_r16_c13.png,16,13,735,284,767,300,32,16
cell_r16_c14.png,16,14,767,284,823,301,56,17
cell_r16_c15.png,16,15,823,284,888,301,65,17
cell_r16_c16.png,16,16,887,284,920,300,33,16
cell_r16_c17.png,16,17,920,284,986,301,66,17
cell_r16_c18.png,16,18,986,284,1051,301,65,17
cell_r16_c0.png,16,0,1,282,16,299,15,17
cell_r16_c1.png,16,1,16,282,229,299,213,17
cell_r16_c2.png,16,2,228,283,279,300,51,17
cell_r16_c3.png,16,3,279,283,323,300,44,17
cell_r16_c4.png,16,4,323,283,359,300,36,17
cell_r16_c5.png,16,5,359,283,391,300,32,17
cell_r16_c6.png,16,6,391,283,446,300,55,17
cell_r16_c7.png,16,7,446,283,502,300,56,17
cell_r16_c8.png,16,8,502,284,538,300,36,16
cell_r16_c9.png,16,9,538,284,571,300,33,16
cell_r16_c10.png,16,10,570,284,627,300,57,16
cell_r16_c11.png,16,11,627,284,698,300,71,16
cell_r16_c12.png,16,12,698,284,735,300,37,16
cell_r16_c13.png,16,13,735,284,767,300,32,16
cell_r16_c14.png,16,14,767,284,823,301,56,17
cell_r16_c15.png,16,15,823,284,888,301,65,17
cell_r16_c16.png,16,16,887,284,920,300,33,16
cell_r16_c17.png,16,17,920,284,986,301,66,17
cell_r16_c18.png,16,18,986,284,1051,301,65,17
cell_r16_c0.png,16,0,1,282,16,299,15,17
cell_r16_c1.png,16,1,16,282,229,299,213,17
cell_r16_c2.png,16,2,228,283,279,300,51,17
cell_r16_c3.png,16,3,279,283,323,300,44,17
cell_r16_c4.png,16,4,323,283,359,300,36,17
cell_r16_c5.png,16,5,359,283,391,300,32,17
cell_r16_c6.png,16,6,391,283,446,300,55,17
cell_r16_c7.png,16,7,446,283,502,300,56,17
cell_r16_c8.png,16,8,502,284,538,300,36,16
cell_r16_c9.png,16,9,538,284,571,300,33,16
cell_r16_c10.png,16,10,570,284,627,300,57,16
cell_r16_c11.png,16,11,627,284,698,300,71,16
cell_r16_c12.png,16,12,698,284,735,300,37,16
cell_r16_c13.png,16,13,735,284,767,300,32,16
cell_r16_c14.png,16,14,767,284,823,301,56,17
cell_r16_c15.png,16,15,823,284,888,301,65,17
cell_r16_c16.png,16,16,887,284,920,300,33,16
cell_r16_c17.png,16,17,920,284,986,301,66,17
cell_r16_c18.png,16,18,986,284,1051,301,65,17
cell_r16_c0.png,16,0,1,282,16,299,15,17
cell_r16_c1.png,16,1,16,282,229,299,213,17
cell_r16_c2.png,16,2,228,283,279,300,51,17
cell_r16_c3.png,16,3,279,283,323,300,44,17
cell_r16_c4.png,16,4,323,283,359,300,36,17
cell_r16_c5.png,16,5,359,283,391,300,32,17
cell_r16_c6.png,16,6,391,283,446,300,55,17
cell_r16_c7.png,16,7,446,283,502,300,56,17
cell_r16_c8.png,16,8,502,284,538,300,36,16
cell_r16_c9.png,16,9,538,284,571,300,33,16
cell_r16_c10.png,16,10,570,284,627,300,57,16
cell_r16_c11.png,16,11,627,284,698,300,71,16
cell_r16_c12.png,16,12,698,284,735,300,37,16
cell_r16_c13.png,16,13,735,284,767,300,32,16
cell_r16_c14.png,16,14,767,284,823,301,56,17
cell_r16_c15.png,16,15,823,284,888,301,65,17
cell_r16_c16.png,16,16,887,284,920,300,33,16
cell_r16_c17.png,16,17,920,284,986,301,66,17
cell_r16_c18.png,16,18,986,284,1051,301,65,17
cell_r16_c0.png,16,0,1,282,16,299,15,17
cell_r16_c1.png,16,1,16,282,229,299,213,17
cell_r16_c2.png,16,2,228,283,279,300,51,17
cell_r16_c3.png,16,3,279,283,323,300,44,17
cell_r16_c4.png,16,4,323,283,359,300,36,17
cell_r16_c5.png,16,5,359,283,391,300,32,17
cell_r16_c6.png,16,6,391,283,446,300,55,17
cell_r16_c7.png,16,7,446,283,502,300,56,17
cell_r16_c8.png,16,8,502,284,538,300,36,16
cell_r16_c9.png,16,9,538,284,571,300,33,16
cell_r16_c10.png,16,10,570,284,627,300,57,16
cell_r16_c11.png,16,11,627,284,698,300,71,16
cell_r16_c12.png,16,12,698,284,735,300,37,16
cell_r16_c13.png,16,13,735,284,767,300,32,16
cell_r16_c14.png,16,14,767,284,823,301,56,17
cell_r16_c15.png,16,15,823,284,888,301,65,17
cell_r16_c16.png,16,16,887,284,920,300,33,16
cell_r16_c17.png,16,17,920,284,986,301,66,17
cell_r16_c18.png,16,18,986,284,1051,301,65,17
cell_r16_c0.png,16,0,1,282,16,299,15,17
cell_r16_c1.png,16,1,16,282,229,299,213,17
cell_r16_c2.png,16,2,228,283,279,300,51,17
cell_r16_c3.png,16,3,279,283,323,300,44,17
cell_r16_c4.png,16,4,323,283,359,300,36,17
cell_r16_c5.png,16,5,359,283,391,300,32,17
cell_r16_c6.png,16,6,391,283,446,300,55,17
cell_r16_c7.png,16,7,446,283,502,300,56,17
cell_r16_c8.png,16,8,502,284,538,300,36,16
cell_r16_c9.png,16,9,538,284,571,300,33,16
cell_r16_c10.png,16,10,570,284,627,300,57,16
cell_r16_c11.png,16,11,627,284,698,300,71,16
cell_r16_c12.png,16,12,698,284,735,300,37,16
cell_r16_c13.png,16,13,735,284,767,300,32,16
cell_r16_c14.png,16,14,767,284,823,301,56,17
cell_r16_c15.png,16,15,823,284,888,301,65,17
cell_r16_c16.png,16,16,887,284,920,300,33,16
cell_r16_c17.png,16,17,920,284,986,301,66,17
cell_r16_c18.png,16,18,986,284,1051,301,65,17
cell_r16_c0.png,16,0,1,282,16,299,15,17
cell_r16_c1.png,16,1,16,282,229,299,213,17
cell_r16_c2.png,16,2,228,283,279,300,51,17
cell_r16_c3.png,16,3,279,283,323,300,44,17
cell_r16_c4.png,16,4,323,283,359,300,36,17
cell_r16_c5.png,16,5,359,283,391,300,32,17
cell_r16_c6.png,16,6,391,283,446,300,55,17
cell_r16_c7.png,16,7,446,283,502,300,56,17
cell_r16_c8.png,16,8,502,284,538,300,36,16
cell_r16_c9.png,16,9,538,284,571,300,33,16
cell_r16_c10.png,16,10,570,284,627,300,57,16
cell_r16_c11.png,16,11,627,284,698,300,71,16
cell_r16_c12.png,16,12,698,284,735,300,37,16
cell_r16_c13.png,16,13,735,284,767,300,32,16
cell_r16_c14.png,16,14,767,284,823,301,56,17
cell_r16_c15.png,16,15,823,284,888,301,65,17
cell_r16_c16.png,16,16,887,284,920,300,33,16
cell_r16_c17.png,16,17,920,284,986,301,66,17
cell_r16_c18.png,16,18,986,284,1051,301,65,17
cell_r16_c0.png,16,0,1,282,16,299,15,17
cell_r16_c1.png,16,1,16,282,229,299,213,17
cell_r16_c2.png,16,2,228,283,279,300,51,17
cell_r16_c3.png,16,3,279,283,323,300,44,17
cell_r16_c4.png,16,4,323,283,359,300,36,17
cell_r16_c5.png,16,5,359,283,391,300,32,17
cell_r16_c6.png,16,6,391,283,446,300,55,17
cell_r16_c7.png,16,7,446,283,502,300,56,17
cell_r16_c8.png,16,8,502,284,538,300,36,16
cell_r16_c9.png,16,9,538,284,571,300,33,16
cell_r16_c10.png,16,10,570,284,627,300,57,16
cell_r16_c11.png,16,11,627,284,698,300,71,16
cell_r16_c12.png,16,12,698,284,735,300,37,16
cell_r16_c13.png,16,13,735,284,767,300,32,16
cell_r16_c14.png,16,14,767,284,823,301,56,17
cell_r16_c15.png,16,15,823,284,888,301,65,17
cell_r16_c16.png,16,16,887,284,920,300,33,16
cell_r16_c17.png,16,17,920,284,986,301,66,17
cell_r16_c18.png,16,18,986,284,1051,301,65,17
cell_r16_c0.png,16,0,1,282,16,299,15,17
cell_r16_c1.png,16,1,16,282,229,299,213,17
cell_r16_c2.png,16,2,228,283,279,300,51,17
cell_r16_c3.png,16,3,279,283,323,300,44,17
cell_r16_c4.png,16,4,323,283,359,300,36,17
cell_r16_c5.png,16,5,359,283,391,300,32,17
cell_r16_c6.png,16,6,391,283,446,300,55,17
cell_r16_c7.png,16,7,446,283,502,300,56,17
cell_r16_c8.png,16,8,502,284,538,300,36,16
cell_r16_c9.png,16,9,538,284,571,300,33,16
cell_r16_c10.png,16,10,570,284,627,300,57,16
cell_r16_c11.png,16,11,627,284,698,300,71,16
cell_r16_c12.png,16,12,698,284,735,300,37,16
cell_r16_c13.png,16,13,735,284,767,300,32,16
cell_r16_c14.png,16,14,767,284,823,301,56,17
cell_r16_c15.png,16,15,823,284,888,301,65,17
cell_r16_c16.png,16,16,887,284,920,300,33,16
cell_r16_c17.png,16,17,920,284,986,301,66,17
cell_r16_c18.png,16,18,986,284,1051,301,65,17
cell_r16_c0.png,16,0,1,282,16,299,15,17
cell_r16_c1.png,16,1,16,282,229,299,213,17
cell_r16_c2.png,16,2,228,283,279,300,51,17
cell_r16_c3.png,16,3,279,283,323,300,44,17
cell_r16_c4.png,16,4,323,283,359,300,36,17
cell_r16_c5.png,16,5,359,283,391,300,32,17
cell_r16_c6.png,16,6,391,283,446,300,55,17
cell_r16_c7.png,16,7,446,283,502,300,56,17
cell_r16_c8.png,16,8,502,284,538,300,36,16
cell_r16_c9.png,16,9,538,284,571,300,33,16
cell_r16_c10.png,16,10,570,284,627,300,57,16
cell_r16_c11.png,16,11,627,284,698,300,71,16
cell_r16_c12.png,16,12,698,284,735,300,37,16
cell_r16_c13.png,16,13,735,284,767,300,32,16
cell_r16_c14.png,16,14,767,284,823,301,56,17
cell_r16_c15.png,16,15,823,284,888,301,65,17
cell_r16_c16.png,16,16,887,284,920,300,33,16
cell_r16_c17.png,16,17,920,284,986,301,66,17
cell_r16_c18.png,16,18,986,284,1051,301,65,17
cell_r16_c0.png,16,0,1,282,16,299,15,17
cell_r16_c1.png,16,1,16,282,229,299,213,17
cell_r16_c2.png,16,2,228,283,279,300,51,17
cell_r16_c3.png,16,3,279,283,323,300,44,17
cell_r16_c4.png,16,4,323,283,359,300,36,17
cell_r16_c5.png,16,5,359,283,391,300,32,17
cell_r16_c6.png,16,6,391,283,446,300,55,17
cell_r16_c7.png,16,7,446,283,502,300,56,17
cell_r16_c8.png,16,8,502,284,538,300,36,16
cell_r16_c9.png,16,9,538,284,571,300,33,16
cell_r16_c10.png,16,10,570,284,627,300,57,16
cell_r16_c11.png,16,11,627,284,698,300,71,16
cell_r16_c12.png,16,12,698,284,735,300,37,16
cell_r16_c13.png,16,13,735,284,767,300,32,16
cell_r16_c14.png,16,14,767,284,823,301,56,17
cell_r16_c15.png,16,15,823,284,888,301,65,17
cell_r16_c16.png,16,16,887,284,920,300,33,16
cell_r16_c17.png,16,17,920,284,986,301,66,17
cell_r16_c18.png,16,18,986,284,1051,301,65,17
cell_r16_c0.png,16,0,1,282,16,299,15,17
cell_r16_c1.png,16,1,16,282,229,299,213,17
cell_r16_c2.png,16,2,228,283,279,300,51,17
cell_r16_c3.png,16,3,279,283,323,300,44,17
cell_r16_c4.png,16,4,323,283,359,300,36,17
cell_r16_c5.png,16,5,359,283,391,300,32,17
cell_r16_c6.png,16,6,391,283,446,300,55,17
cell_r16_c7.png,16,7,446,283,502,300,56,17
cell_r16_c8.png,16,8,502,284,538,300,36,16
cell_r16_c9.png,16,9,538,284,571,300,33,16
cell_r16_c10.png,16,10,570,284,627,300,57,16
cell_r16_c11.png,16,11,627,284,698,300,71,16
cell_r16_c12.png,16,12,698,284,735,300,37,16
cell_r16_c13.png,16,13,735,284,767,300,32,16
cell_r16_c14.png,16,14,767,284,823,301,56,17
cell_r16_c15.png,16,15,823,284,888,301,65,17
cell_r16_c16.png,16,16,887,284,920,300,33,16
cell_r16_c17.png,16,17,920,284,986,301,66,17
cell_r16_c18.png,16,18,986,284,1051,301,65,17
cell_r16_c0.png,16,0,1,282,16,299,15,17
cell_r16_c1.png,16,1,16,282,229,299,213,17
cell_r16_c2.png,16,2,228,283,279,300,51,17
cell_r16_c3.png,16,3,279,283,323,300,44,17
cell_r16_c4.png,16,4,323,283,359,300,36,17
cell_r16_c5.png,16,5,359,283,391,300,32,17
cell_r16_c6.png,16,6,391,283,446,300,55,17
cell_r16_c7.png,16,7,446,283,502,300,56,17
cell_r16_c8.png,16,8,502,284,538,300,36,16
cell_r16_c9.png,16,9,538,284,571,300,33,16
cell_r16_c10.png,16,10,570,284,627,300,57,16
cell_r16_c11.png,16,11,627,284,698,300,71,16
cell_r16_c12.png,16,12,698,284,735,300,37,16
cell_r16_c13.png,16,13,735,284,767,300,32,16
cell_r16_c14.png,16,14,767,284,823,301,56,17
cell_r16_c15.png,16,15,823,284,888,301,65,17
cell_r16_c16.png,16,16,887,284,920,300,33,16
cell_r16_c17.png,16,17,920,284,986,301,66,17
cell_r16_c18.png,16,18,986,284,1051,301,65,17
cell_r16_c0.png,16,0,1,282,16,299,15,17
cell_r16_c1.png,16,1,16,282,229,299,213,17
cell_r16_c2.png,16,2,228,283,279,300,51,17
cell_r16_c3.png,16,3,279,283,323,300,44,17
cell_r16_c4.png,16,4,323,283,359,300,36,17
cell_r16_c5.png,16,5,359,283,391,300,32,17
cell_r16_c6.png,16,6,391,283,446,300,55,17
cell_r16_c7.png,16,7,446,283,502,300,56,17
cell_r16_c8.png,16,8,502,284,538,300,36,16
cell_r16_c9.png,16,9,538,284,571,300,33,16
cell_r16_c10.png,16,10,570,284,627,300,57,16
cell_r16_c11.png,16,11,627,284,698,300,71,16
cell_r16_c12.png,16,12,698,284,735,300,37,16
cell_r16_c13.png,16,13,735,284,767,300,32,16
cell_r16_c14.png,16,14,767,284,823,301,56,17
cell_r16_c15.png,16,15,823,284,888,301,65,17
cell_r16_c16.png,16,16,887,284,920,300,33,16
cell_r16_c17.png,16,17,920,284,986,301,66,17
cell_r16_c18.png,16,18,986,284,1051,301,65,17
cell_r16_c0.png,16,0,1,282,16,299,15,17
cell_r16_c1.png,16,1,16,282,229,299,213,17
cell_r16_c2.png,16,2,228,283,279,300,51,17
cell_r16_c3.png,16,3,279,283,323,300,44,17
cell_r16_c4.png,16,4,323,283,359,300,36,17
cell_r16_c5.png,16,5,359,283,391,300,32,17
cell_r16_c6.png,16,6,391,283,446,300,55,17
cell_r16_c7.png,16,7,446,283,502,300,56,17
cell_r16_c8.png,16,8,502,284,538,300,36,16
cell_r16_c9.png,16,9,538,284,571,300,33,16
cell_r16_c10.png,16,10,570,284,627,300,57,16
cell_r16_c11.png,16,11,627,284,698,300,71,16
cell_r16_c12.png,16,12,698,284,735,300,37,16
cell_r16_c13.png,16,13,735,284,767,300,32,16
cell_r16_c14.png,16,14,767,284,823,301,56,17
cell_r16_c15.png,16,15,823,284,888,301,65,17
cell_r16_c16.png,16,16,887,284,920,300,33,16
cell_r16_c17.png,16,17,920,284,986,301,66,17
cell_r16_c18.png,16,18,986,284,1051,301,65,17
cell_r16_c0.png,16,0,1,282,16,299,15,17
cell_r16_c1.png,16,1,16,282,229,299,213,17
cell_r16_c2.png,16,2,228,283,279,300,51,17
cell_r16_c3.png,16,3,279,283,323,300,44,17
cell_r16_c4.png,16,4,323,283,359,300,36,17
cell_r16_c5.png,16,5,359,283,391,300,32,17
cell_r16_c6.png,16,6,391,283,446,300,55,17
cell_r16_c7.png,16,7,446,283,502,300,56,17
cell_r16_c8.png,16,8,502,284,538,300,36,16
cell_r16_c9.png,16,9,538,284,571,300,33,16
cell_r16_c10.png,16,10,570,284,627,300,57,16
cell_r16_c11.png,16,11,627,284,698,300,71,16
cell_r16_c12.png,16,12,698,284,735,300,37,16
cell_r16_c13.png,16,13,735,284,767,300,32,16
cell_r16_c14.png,16,14,767,284,823,301,56,17
cell_r16_c15.png,16,15,823,284,888,301,65,17
cell_r16_c16.png,16,16,887,284,920,300,33,16
cell_r16_c17.png,16,17,920,284,986,301,66,17
cell_r16_c18.png,16,18,986,284,1051,301,65,17
cell_r16_c0.png,16,0,1,282,16,299,15,17
cell_r16_c1.png,16,1,16,282,229,299,213,17
cell_r16_c2.png,16,2,228,283,279,300,51,17
cell_r16_c3.png,16,3,279,283,323,300,44,17
cell_r16_c4.png,16,4,323,283,359,300,36,17
cell_r16_c5.png,16,5,359,283,391,300,32,17
cell_r16_c6.png,16,6,391,283,446,300,55,17
cell_r16_c7.png,16,7,446,283,502,300,56,17
cell_r16_c8.png,16,8,502,284,538,300,36,16
cell_r16_c9.png,16,9,538,284,571,300,33,16
cell_r16_c10.png,16,10,570,284,627,300,57,16
cell_r16_c11.png,16,11,627,284,698,300,71,16
cell_r16_c12.png,16,12,698,284,735,300,37,16
cell_r16_c13.png,16,13,735,284,767,300,32,16
cell_r16_c14.png,16,14,767,284,823,301,56,17
cell_r16_c15.png,16,15,823,284,888,301,65,17
cell_r16_c16.png,16,16,887,284,920,300,33,16
cell_r16_c17.png,16,17,920,284,986,301,66,17
cell_r16_c18.png,16,18,986,284,1051,301,65,17
cell_r16_c0.png,16,0,1,282,16,299,15,17
cell_r16_c1.png,16,1,16,282,229,299,213,17
cell_r16_c2.png,16,2,228,283,279,300,51,17
cell_r16_c3.png,16,3,279,283,323,300,44,17
cell_r16_c4.png,16,4,323,283,359,300,36,17
cell_r16_c5.png,16,5,359,283,391,300,32,17
cell_r16_c6.png,16,6,391,283,446,300,55,17
cell_r16_c7.png,16,7,446,283,502,300,56,17
cell_r16_c8.png,16,8,502,284,538,300,36,16
cell_r16_c9.png,16,9,538,284,571,300,33,16
cell_r16_c10.png,16,10,570,284,627,300,57,16
cell_r16_c11.png,16,11,627,284,698,300,71,16
cell_r16_c12.png,16,12,698,284,735,300,37,16
cell_r16_c13.png,16,13,735,284,767,300,32,16
cell_r16_c14.png,16,14,767,284,823,301,56,17
cell_r16_c15.png,16,15,823,284,888,301,65,17
cell_r16_c16.png,16,16,887,284,920,300,33,16
cell_r16_c17.png,16,17,920,284,986,301,66,17
cell_r16_c18.png,16,18,986,284,1051,301,65,17
cell_r16_c0.png,16,0,1,282,16,299,15,17
cell_r16_c1.png,16,1,16,282,229,299,213,17
cell_r16_c2.png,16,2,228,283,279,300,51,17
cell_r16_c3.png,16,3,279,283,323,300,44,17
cell_r16_c4.png,16,4,323,283,359,300,36,17
cell_r16_c5.png,16,5,359,283,391,300,32,17
cell_r16_c6.png,16,6,391,283,446,300,55,17
cell_r16_c7.png,16,7,446,283,502,300,56,17
cell_r16_c8.png,16,8,502,284,538,300,36,16
cell_r16_c9.png,16,9,538,284,571,300,33,16
cell_r16_c10.png,16,10,570,284,627,300,57,16
cell_r16_c11.png,16,11,627,284,698,300,71,16
cell_r16_c12.png,16,12,698,284,735,300,37,16
cell_r16_c13.png,16,13,735,284,767,300,32,16
cell_r16_c14.png,16,14,767,284,823,301,56,17
cell_r16_c15.png,16,15,823,284,888,301,65,17
cell_r16_c16.png,16,16,887,284,920,300,33,16
cell_r16_c17.png,16,17,920,284,986,301,66,17
cell_r16_c18.png,16,18,986,284,1051,301,65,17
cell_r17_c0.png,17,0,1,299,16,316,15,17
cell_r17_c1.png,17,1,16,299,228,316,212,17
cell_r17_c2.png,17,2,228,299,279,316,51,17
cell_r17_c3.png,17,3,279,300,323,317,44,17
cell_r17_c4.png,17,4,323,300,359,317,36,17
cell_r17_c5.png,17,5,359,299,391,317,32,18
cell_r17_c6.png,17,6,391,299,446,316,55,17
cell_r17_c7.png,17,7,446,300,502,317,56,17
cell_r17_c8.png,17,8,502,300,538,317,36,17
cell_r17_c9.png,17,9,538,300,570,317,32,17
cell_r17_c10.png,17,10,570,300,627,318,57,18
cell_r17_c11.png,17,11,627,300,698,318,71,18
cell_r17_c12.png,17,12,698,300,735,317,37,17
cell_r17_c13.png,17,13,735,300,767,318,32,18
cell_r17_c14.png,17,14,767,300,823,318,56,18
cell_r17_c15.png,17,15,823,300,888,318,65,18
cell_r17_c16.png,17,16,887,300,920,318,33,18
cell_r17_c17.png,17,17,920,300,986,318,66,18
cell_r17_c18.png,17,18,986,301,1051,318,65,17
cell_r17_c0.png,17,0,1,299,16,316,15,17
cell_r17_c1.png,17,1,16,299,228,316,212,17
cell_r17_c2.png,17,2,228,299,279,316,51,17
cell_r17_c3.png,17,3,279,300,323,317,44,17
cell_r17_c4.png,17,4,323,300,359,317,36,17
cell_r17_c5.png,17,5,359,299,391,317,32,18
cell_r17_c6.png,17,6,391,299,446,316,55,17
cell_r17_c7.png,17,7,446,300,502,317,56,17
cell_r17_c8.png,17,8,502,300,538,317,36,17
cell_r17_c9.png,17,9,538,300,570,317,32,17
cell_r17_c10.png,17,10,570,300,627,318,57,18
cell_r17_c11.png,17,11,627,300,698,318,71,18
cell_r17_c12.png,17,12,698,300,735,317,37,17
cell_r17_c13.png,17,13,735,300,767,318,32,18
cell_r17_c14.png,17,14,767,300,823,318,56,18
cell_r17_c15.png,17,15,823,300,888,318,65,18
cell_r17_c16.png,17,16,887,300,920,318,33,18
cell_r17_c17.png,17,17,920,300,986,318,66,18
cell_r17_c18.png,17,18,986,301,1051,318,65,17
cell_r17_c0.png,17,0,1,299,16,316,15,17
cell_r17_c1.png,17,1,16,299,228,316,212,17
cell_r17_c2.png,17,2,228,299,279,316,51,17
cell_r17_c3.png,17,3,279,300,323,317,44,17
cell_r17_c4.png,17,4,323,300,359,317,36,17
cell_r17_c5.png,17,5,359,299,391,317,32,18
cell_r17_c6.png,17,6,391,299,446,316,55,17
cell_r17_c7.png,17,7,446,300,502,317,56,17
cell_r17_c8.png,17,8,502,300,538,317,36,17
cell_r17_c9.png,17,9,538,300,570,317,32,17
cell_r17_c10.png,17,10,570,300,627,318,57,18
cell_r17_c11.png,17,11,627,300,698,318,71,18
cell_r17_c12.png,17,12,698,300,735,317,37,17
cell_r17_c13.png,17,13,735,300,767,318,32,18
cell_r17_c14.png,17,14,767,300,823,318,56,18
cell_r17_c15.png,17,15,823,300,888,318,65,18
cell_r17_c16.png,17,16,887,300,920,318,33,18
cell_r17_c17.png,17,17,920,300,986,318,66,18
cell_r17_c18.png,17,18,986,301,1051,318,65,17
cell_r17_c0.png,17,0,1,299,16,316,15,17
cell_r17_c1.png,17,1,16,299,228,316,212,17
cell_r17_c2.png,17,2,228,299,279,316,51,17
cell_r17_c3.png,17,3,279,300,323,317,44,17
cell_r17_c4.png,17,4,323,300,359,317,36,17
cell_r17_c5.png,17,5,359,299,391,317,32,18
cell_r17_c6.png,17,6,391,299,446,316,55,17
cell_r17_c7.png,17,7,446,300,502,317,56,17
cell_r17_c8.png,17,8,502,300,538,317,36,17
cell_r17_c9.png,17,9,538,300,570,317,32,17
cell_r17_c10.png,17,10,570,300,627,318,57,18
cell_r17_c11.png,17,11,627,300,698,318,71,18
cell_r17_c12.png,17,12,698,300,735,317,37,17
cell_r17_c13.png,17,13,735,300,767,318,32,18
cell_r17_c14.png,17,14,767,300,823,318,56,18
cell_r17_c15.png,17,15,823,300,888,318,65,18
cell_r17_c16.png,17,16,887,300,920,318,33,18
cell_r17_c17.png,17,17,920,300,986,318,66,18
cell_r17_c18.png,17,18,986,301,1051,318,65,17
cell_r17_c0.png,17,0,1,299,16,316,15,17
cell_r17_c1.png,17,1,16,299,228,316,212,17
cell_r17_c2.png,17,2,228,299,279,316,51,17
cell_r17_c3.png,17,3,279,300,323,317,44,17
cell_r17_c4.png,17,4,323,300,359,317,36,17
cell_r17_c5.png,17,5,359,299,391,317,32,18
cell_r17_c6.png,17,6,391,299,446,316,55,17
cell_r17_c7.png,17,7,446,300,502,317,56,17
cell_r17_c8.png,17,8,502,300,538,317,36,17
cell_r17_c9.png,17,9,538,300,570,317,32,17
cell_r17_c10.png,17,10,570,300,627,318,57,18
cell_r17_c11.png,17,11,627,300,698,318,71,18
cell_r17_c12.png,17,12,698,300,735,317,37,17
cell_r17_c13.png,17,13,735,300,767,318,32,18
cell_r17_c14.png,17,14,767,300,823,318,56,18
cell_r17_c15.png,17,15,823,300,888,318,65,18
cell_r17_c16.png,17,16,887,300,920,318,33,18
cell_r17_c17.png,17,17,920,300,986,318,66,18
cell_r17_c18.png,17,18,986,301,1051,318,65,17
cell_r17_c0.png,17,0,1,299,16,316,15,17
cell_r17_c1.png,17,1,16,299,228,316,212,17
cell_r17_c2.png,17,2,228,299,279,316,51,17
cell_r17_c3.png,17,3,279,300,323,317,44,17
cell_r17_c4.png,17,4,323,300,359,317,36,17
cell_r17_c5.png,17,5,359,299,391,317,32,18
cell_r17_c6.png,17,6,391,299,446,316,55,17
cell_r17_c7.png,17,7,446,300,502,317,56,17
cell_r17_c8.png,17,8,502,300,538,317,36,17
cell_r17_c9.png,17,9,538,300,570,317,32,17
cell_r17_c10.png,17,10,570,300,627,318,57,18
cell_r17_c11.png,17,11,627,300,698,318,71,18
cell_r17_c12.png,17,12,698,300,735,317,37,17
cell_r17_c13.png,17,13,735,300,767,318,32,18
cell_r17_c14.png,17,14,767,300,823,318,56,18
cell_r17_c15.png,17,15,823,300,888,318,65,18
cell_r17_c16.png,17,16,887,300,920,318,33,18
cell_r17_c17.png,17,17,920,300,986,318,66,18
cell_r17_c18.png,17,18,986,301,1051,318,65,17
cell_r17_c0.png,17,0,1,299,16,316,15,17
cell_r17_c1.png,17,1,16,299,228,316,212,17
cell_r17_c2.png,17,2,228,299,279,316,51,17
cell_r17_c3.png,17,3,279,300,323,317,44,17
cell_r17_c4.png,17,4,323,300,359,317,36,17
cell_r17_c5.png,17,5,359,299,391,317,32,18
cell_r17_c6.png,17,6,391,299,446,316,55,17
cell_r17_c7.png,17,7,446,300,502,317,56,17
cell_r17_c8.png,17,8,502,300,538,317,36,17
cell_r17_c9.png,17,9,538,300,570,317,32,17
cell_r17_c10.png,17,10,570,300,627,318,57,18
cell_r17_c11.png,17,11,627,300,698,318,71,18
cell_r17_c12.png,17,12,698,300,735,317,37,17
cell_r17_c13.png,17,13,735,300,767,318,32,18
cell_r17_c14.png,17,14,767,300,823,318,56,18
cell_r17_c15.png,17,15,823,300,888,318,65,18
cell_r17_c16.png,17,16,887,300,920,318,33,18
cell_r17_c17.png,17,17,920,300,986,318,66,18
cell_r17_c18.png,17,18,986,301,1051,318,65,17
cell_r17_c0.png,17,0,1,299,16,316,15,17
cell_r17_c1.png,17,1,16,299,228,316,212,17
cell_r17_c2.png,17,2,228,299,279,316,51,17
cell_r17_c3.png,17,3,279,300,323,317,44,17
cell_r17_c4.png,17,4,323,300,359,317,36,17
cell_r17_c5.png,17,5,359,299,391,317,32,18
cell_r17_c6.png,17,6,391,299,446,316,55,17
cell_r17_c7.png,17,7,446,300,502,317,56,17
cell_r17_c8.png,17,8,502,300,538,317,36,17
cell_r17_c9.png,17,9,538,300,570,317,32,17
cell_r17_c10.png,17,10,570,300,627,318,57,18
cell_r17_c11.png,17,11,627,300,698,318,71,18
cell_r17_c12.png,17,12,698,300,735,317,37,17
cell_r17_c13.png,17,13,735,300,767,318,32,18
cell_r17_c14.png,17,14,767,300,823,318,56,18
cell_r17_c15.png,17,15,823,300,888,318,65,18
cell_r17_c16.png,17,16,887,300,920,318,33,18
cell_r17_c17.png,17,17,920,300,986,318,66,18
cell_r17_c18.png,17,18,986,301,1051,318,65,17
cell_r17_c0.png,17,0,1,299,16,316,15,17
cell_r17_c1.png,17,1,16,299,228,316,212,17
cell_r17_c2.png,17,2,228,299,279,316,51,17
cell_r17_c3.png,17,3,279,300,323,317,44,17
cell_r17_c4.png,17,4,323,300,359,317,36,17
cell_r17_c5.png,17,5,359,299,391,317,32,18
cell_r17_c6.png,17,6,391,299,446,316,55,17
cell_r17_c7.png,17,7,446,300,502,317,56,17
cell_r17_c8.png,17,8,502,300,538,317,36,17
cell_r17_c9.png,17,9,538,300,570,317,32,17
cell_r17_c10.png,17,10,570,300,627,318,57,18
cell_r17_c11.png,17,11,627,300,698,318,71,18
cell_r17_c12.png,17,12,698,300,735,317,37,17
cell_r17_c13.png,17,13,735,300,767,318,32,18
cell_r17_c14.png,17,14,767,300,823,318,56,18
cell_r17_c15.png,17,15,823,300,888,318,65,18
cell_r17_c16.png,17,16,887,300,920,318,33,18
cell_r17_c17.png,17,17,920,300,986,318,66,18
cell_r17_c18.png,17,18,986,301,1051,318,65,17
cell_r17_c0.png,17,0,1,299,16,316,15,17
cell_r17_c1.png,17,1,16,299,228,316,212,17
cell_r17_c2.png,17,2,228,299,279,316,51,17
cell_r17_c3.png,17,3,279,300,323,317,44,17
cell_r17_c4.png,17,4,323,300,359,317,36,17
cell_r17_c5.png,17,5,359,299,391,317,32,18
cell_r17_c6.png,17,6,391,299,446,316,55,17
cell_r17_c7.png,17,7,446,300,502,317,56,17
cell_r17_c8.png,17,8,502,300,538,317,36,17
cell_r17_c9.png,17,9,538,300,570,317,32,17
cell_r17_c10.png,17,10,570,300,627,318,57,18
cell_r17_c11.png,17,11,627,300,698,318,71,18
cell_r17_c12.png,17,12,698,300,735,317,37,17
cell_r17_c13.png,17,13,735,300,767,318,32,18
cell_r17_c14.png,17,14,767,300,823,318,56,18
cell_r17_c15.png,17,15,823,300,888,318,65,18
cell_r17_c16.png,17,16,887,300,920,318,33,18
cell_r17_c17.png,17,17,920,300,986,318,66,18
cell_r17_c18.png,17,18,986,301,1051,318,65,17
cell_r17_c0.png,17,0,1,299,16,316,15,17
cell_r17_c1.png,17,1,16,299,228,316,212,17
cell_r17_c2.png,17,2,228,299,279,316,51,17
cell_r17_c3.png,17,3,279,300,323,317,44,17
cell_r17_c4.png,17,4,323,300,359,317,36,17
cell_r17_c5.png,17,5,359,299,391,317,32,18
cell_r17_c6.png,17,6,391,299,446,316,55,17
cell_r17_c7.png,17,7,446,300,502,317,56,17
cell_r17_c8.png,17,8,502,300,538,317,36,17
cell_r17_c9.png,17,9,538,300,570,317,32,17
cell_r17_c10.png,17,10,570,300,627,318,57,18
cell_r17_c11.png,17,11,627,300,698,318,71,18
cell_r17_c12.png,17,12,698,300,735,317,37,17
cell_r17_c13.png,17,13,735,300,767,318,32,18
cell_r17_c14.png,17,14,767,300,823,318,56,18
cell_r17_c15.png,17,15,823,300,888,318,65,18
cell_r17_c16.png,17,16,887,300,920,318,33,18
cell_r17_c17.png,17,17,920,300,986,318,66,18
cell_r17_c18.png,17,18,986,301,1051,318,65,17
cell_r17_c0.png,17,0,1,299,16,316,15,17
cell_r17_c1.png,17,1,16,299,228,316,212,17
cell_r17_c2.png,17,2,228,299,279,316,51,17
cell_r17_c3.png,17,3,279,300,323,317,44,17
cell_r17_c4.png,17,4,323,300,359,317,36,17
cell_r17_c5.png,17,5,359,299,391,317,32,18
cell_r17_c6.png,17,6,391,299,446,316,55,17
cell_r17_c7.png,17,7,446,300,502,317,56,17
cell_r17_c8.png,17,8,502,300,538,317,36,17
cell_r17_c9.png,17,9,538,300,570,317,32,17
cell_r17_c10.png,17,10,570,300,627,318,57,18
cell_r17_c11.png,17,11,627,300,698,318,71,18
cell_r17_c12.png,17,12,698,300,735,317,37,17
cell_r17_c13.png,17,13,735,300,767,318,32,18
cell_r17_c14.png,17,14,767,300,823,318,56,18
cell_r17_c15.png,17,15,823,300,888,318,65,18
cell_r17_c16.png,17,16,887,300,920,318,33,18
cell_r17_c17.png,17,17,920,300,986,318,66,18
cell_r17_c18.png,17,18,986,301,1051,318,65,17
cell_r17_c0.png,17,0,1,299,16,316,15,17
cell_r17_c1.png,17,1,16,299,228,316,212,17
cell_r17_c2.png,17,2,228,299,279,316,51,17
cell_r17_c3.png,17,3,279,300,323,317,44,17
cell_r17_c4.png,17,4,323,300,359,317,36,17
cell_r17_c5.png,17,5,359,299,391,317,32,18
cell_r17_c6.png,17,6,391,299,446,316,55,17
cell_r17_c7.png,17,7,446,300,502,317,56,17
cell_r17_c8.png,17,8,502,300,538,317,36,17
cell_r17_c9.png,17,9,538,300,570,317,32,17
cell_r17_c10.png,17,10,570,300,627,318,57,18
cell_r17_c11.png,17,11,627,300,698,318,71,18
cell_r17_c12.png,17,12,698,300,735,317,37,17
cell_r17_c13.png,17,13,735,300,767,318,32,18
cell_r17_c14.png,17,14,767,300,823,318,56,18
cell_r17_c15.png,17,15,823,300,888,318,65,18
cell_r17_c16.png,17,16,887,300,920,318,33,18
cell_r17_c17.png,17,17,920,300,986,318,66,18
cell_r17_c18.png,17,18,986,301,1051,318,65,17
cell_r17_c0.png,17,0,1,299,16,316,15,17
cell_r17_c1.png,17,1,16,299,228,316,212,17
cell_r17_c2.png,17,2,228,299,279,316,51,17
cell_r17_c3.png,17,3,279,300,323,317,44,17
cell_r17_c4.png,17,4,323,300,359,317,36,17
cell_r17_c5.png,17,5,359,299,391,317,32,18
cell_r17_c6.png,17,6,391,299,446,316,55,17
cell_r17_c7.png,17,7,446,300,502,317,56,17
cell_r17_c8.png,17,8,502,300,538,317,36,17
cell_r17_c9.png,17,9,538,300,570,317,32,17
cell_r17_c10.png,17,10,570,300,627,318,57,18
cell_r17_c11.png,17,11,627,300,698,318,71,18
cell_r17_c12.png,17,12,698,300,735,317,37,17
cell_r17_c13.png,17,13,735,300,767,318,32,18
cell_r17_c14.png,17,14,767,300,823,318,56,18
cell_r17_c15.png,17,15,823,300,888,318,65,18
cell_r17_c16.png,17,16,887,300,920,318,33,18
cell_r17_c17.png,17,17,920,300,986,318,66,18
cell_r17_c18.png,17,18,986,301,1051,318,65,17
cell_r17_c0.png,17,0,1,299,16,316,15,17
cell_r17_c1.png,17,1,16,299,228,316,212,17
cell_r17_c2.png,17,2,228,299,279,316,51,17
cell_r17_c3.png,17,3,279,300,323,317,44,17
cell_r17_c4.png,17,4,323,300,359,317,36,17
cell_r17_c5.png,17,5,359,299,391,317,32,18
cell_r17_c6.png,17,6,391,299,446,316,55,17
cell_r17_c7.png,17,7,446,300,502,317,56,17
cell_r17_c8.png,17,8,502,300,538,317,36,17
cell_r17_c9.png,17,9,538,300,570,317,32,17
cell_r17_c10.png,17,10,570,300,627,318,57,18
cell_r17_c11.png,17,11,627,300,698,318,71,18
cell_r17_c12.png,17,12,698,300,735,317,37,17
cell_r17_c13.png,17,13,735,300,767,318,32,18
cell_r17_c14.png,17,14,767,300,823,318,56,18
cell_r17_c15.png,17,15,823,300,888,318,65,18
cell_r17_c16.png,17,16,887,300,920,318,33,18
cell_r17_c17.png,17,17,920,300,986,318,66,18
cell_r17_c18.png,17,18,986,301,1051,318,65,17
cell_r17_c0.png,17,0,1,299,16,316,15,17
cell_r17_c1.png,17,1,16,299,228,316,212,17
cell_r17_c2.png,17,2,228,299,279,316,51,17
cell_r17_c3.png,17,3,279,300,323,317,44,17
cell_r17_c4.png,17,4,323,300,359,317,36,17
cell_r17_c5.png,17,5,359,299,391,317,32,18
cell_r17_c6.png,17,6,391,299,446,316,55,17
cell_r17_c7.png,17,7,446,300,502,317,56,17
cell_r17_c8.png,17,8,502,300,538,317,36,17
cell_r17_c9.png,17,9,538,300,570,317,32,17
cell_r17_c10.png,17,10,570,300,627,318,57,18
cell_r17_c11.png,17,11,627,300,698,318,71,18
cell_r17_c12.png,17,12,698,300,735,317,37,17
cell_r17_c13.png,17,13,735,300,767,318,32,18
cell_r17_c14.png,17,14,767,300,823,318,56,18
cell_r17_c15.png,17,15,823,300,888,318,65,18
cell_r17_c16.png,17,16,887,300,920,318,33,18
cell_r17_c17.png,17,17,920,300,986,318,66,18
cell_r17_c18.png,17,18,986,301,1051,318,65,17
cell_r17_c0.png,17,0,1,299,16,316,15,17
cell_r17_c1.png,17,1,16,299,228,316,212,17
cell_r17_c2.png,17,2,228,299,279,316,51,17
cell_r17_c3.png,17,3,279,300,323,317,44,17
cell_r17_c4.png,17,4,323,300,359,317,36,17
cell_r17_c5.png,17,5,359,299,391,317,32,18
cell_r17_c6.png,17,6,391,299,446,316,55,17
cell_r17_c7.png,17,7,446,300,502,317,56,17
cell_r17_c8.png,17,8,502,300,538,317,36,17
cell_r17_c9.png,17,9,538,300,570,317,32,17
cell_r17_c10.png,17,10,570,300,627,318,57,18
cell_r17_c11.png,17,11,627,300,698,318,71,18
cell_r17_c12.png,17,12,698,300,735,317,37,17
cell_r17_c13.png,17,13,735,300,767,318,32,18
cell_r17_c14.png,17,14,767,300,823,318,56,18
cell_r17_c15.png,17,15,823,300,888,318,65,18
cell_r17_c16.png,17,16,887,300,920,318,33,18
cell_r17_c17.png,17,17,920,300,986,318,66,18
cell_r17_c18.png,17,18,986,301,1051,318,65,17
cell_r17_c0.png,17,0,1,299,16,316,15,17
cell_r17_c1.png,17,1,16,299,228,316,212,17
cell_r17_c2.png,17,2,228,299,279,316,51,17
cell_r17_c3.png,17,3,279,300,323,317,44,17
cell_r17_c4.png,17,4,323,300,359,317,36,17
cell_r17_c5.png,17,5,359,299,391,317,32,18
cell_r17_c6.png,17,6,391,299,446,316,55,17
cell_r17_c7.png,17,7,446,300,502,317,56,17
cell_r17_c8.png,17,8,502,300,538,317,36,17
cell_r17_c9.png,17,9,538,300,570,317,32,17
cell_r17_c10.png,17,10,570,300,627,318,57,18
cell_r17_c11.png,17,11,627,300,698,318,71,18
cell_r17_c12.png,17,12,698,300,735,317,37,17
cell_r17_c13.png,17,13,735,300,767,318,32,18
cell_r17_c14.png,17,14,767,300,823,318,56,18
cell_r17_c15.png,17,15,823,300,888,318,65,18
cell_r17_c16.png,17,16,887,300,920,318,33,18
cell_r17_c17.png,17,17,920,300,986,318,66,18
cell_r17_c18.png,17,18,986,301,1051,318,65,17
cell_r17_c0.png,17,0,1,299,16,316,15,17
cell_r17_c1.png,17,1,16,299,228,316,212,17
cell_r17_c2.png,17,2,228,299,279,316,51,17
cell_r17_c3.png,17,3,279,300,323,317,44,17
cell_r17_c4.png,17,4,323,300,359,317,36,17
cell_r17_c5.png,17,5,359,299,391,317,32,18
cell_r17_c6.png,17,6,391,299,446,316,55,17
cell_r17_c7.png,17,7,446,300,502,317,56,17
cell_r17_c8.png,17,8,502,300,538,317,36,17
cell_r17_c9.png,17,9,538,300,570,317,32,17
cell_r17_c10.png,17,10,570,300,627,318,57,18
cell_r17_c11.png,17,11,627,300,698,318,71,18
cell_r17_c12.png,17,12,698,300,735,317,37,17
cell_r17_c13.png,17,13,735,300,767,318,32,18
cell_r17_c14.png,17,14,767,300,823,318,56,18
cell_r17_c15.png,17,15,823,300,888,318,65,18
cell_r17_c16.png,17,16,887,300,920,318,33,18
cell_r17_c17.png,17,17,920,300,986,318,66,18
cell_r17_c18.png,17,18,986,301,1051,318,65,17
cell_r18_c0.png,18,0,1,315,16,334,15,19
cell_r18_c1.png,18,1,16,316,228,334,212,18
cell_r18_c2.png,18,2,228,316,279,334,51,18
cell_r18_c3.png,18,3,279,316,323,335,44,19
cell_r18_c4.png,18,4,323,317,359,335,36,18
cell_r18_c5.png,18,5,359,316,391,336,32,20
cell_r18_c6.png,18,6,391,316,446,336,55,20
cell_r18_c7.png,18,7,446,316,502,335,56,19
cell_r18_c8.png,18,8,502,317,538,336,36,19
cell_r18_c9.png,18,9,538,317,570,336,32,19
cell_r18_c10.png,18,10,570,317,627,336,57,19
cell_r18_c11.png,18,11,627,317,698,336,71,19
cell_r18_c12.png,18,12,698,317,735,336,37,19
cell_r18_c13.png,18,13,735,317,767,336,32,19
cell_r18_c14.png,18,14,767,318,823,336,56,18
cell_r18_c15.png,18,15,823,318,888,337,65,19
cell_r18_c16.png,18,16,888,318,920,337,32,19
cell_r18_c17.png,18,17,920,318,986,338,66,20
cell_r18_c18.png,18,18,986,318,1051,338,65,20
cell_r18_c0.png,18,0,1,315,16,334,15,19
cell_r18_c1.png,18,1,16,316,228,334,212,18
cell_r18_c2.png,18,2,228,316,279,334,51,18
cell_r18_c3.png,18,3,279,316,323,335,44,19
cell_r18_c4.png,18,4,323,317,359,335,36,18
cell_r18_c5.png,18,5,359,316,391,336,32,20
cell_r18_c6.png,18,6,391,316,446,336,55,20
cell_r18_c7.png,18,7,446,316,502,335,56,19
cell_r18_c8.png,18,8,502,317,538,336,36,19
cell_r18_c9.png,18,9,538,317,570,336,32,19
cell_r18_c10.png,18,10,570,317,627,336,57,19
cell_r18_c11.png,18,11,627,317,698,336,71,19
cell_r18_c12.png,18,12,698,317,735,336,37,19
cell_r18_c13.png,18,13,735,317,767,336,32,19
cell_r18_c14.png,18,14,767,318,823,336,56,18
cell_r18_c15.png,18,15,823,318,888,337,65,19
cell_r18_c16.png,18,16,888,318,920,337,32,19
cell_r18_c17.png,18,17,920,318,986,338,66,20
cell_r18_c18.png,18,18,986,318,1051,338,65,20
cell_r18_c0.png,18,0,1,315,16,334,15,19
cell_r18_c1.png,18,1,16,316,228,334,212,18
cell_r18_c2.png,18,2,228,316,279,334,51,18
cell_r18_c3.png,18,3,279,316,323,335,44,19
cell_r18_c4.png,18,4,323,317,359,335,36,18
cell_r18_c5.png,18,5,359,316,391,336,32,20
cell_r18_c6.png,18,6,391,316,446,336,55,20
cell_r18_c7.png,18,7,446,316,502,335,56,19
cell_r18_c8.png,18,8,502,317,538,336,36,19
cell_r18_c9.png,18,9,538,317,570,336,32,19
cell_r18_c10.png,18,10,570,317,627,336,57,19
cell_r18_c11.png,18,11,627,317,698,336,71,19
cell_r18_c12.png,18,12,698,317,735,336,37,19
cell_r18_c13.png,18,13,735,317,767,336,32,19
cell_r18_c14.png,18,14,767,318,823,336,56,18
cell_r18_c15.png,18,15,823,318,888,337,65,19
cell_r18_c16.png,18,16,888,318,920,337,32,19
cell_r18_c17.png,18,17,920,318,986,338,66,20
cell_r18_c18.png,18,18,986,318,1051,338,65,20
cell_r18_c0.png,18,0,1,315,16,334,15,19
cell_r18_c1.png,18,1,16,316,228,334,212,18
cell_r18_c2.png,18,2,228,316,279,334,51,18
cell_r18_c3.png,18,3,279,316,323,335,44,19
cell_r18_c4.png,18,4,323,317,359,335,36,18
cell_r18_c5.png,18,5,359,316,391,336,32,20
cell_r18_c6.png,18,6,391,316,446,336,55,20
cell_r18_c7.png,18,7,446,316,502,335,56,19
cell_r18_c8.png,18,8,502,317,538,336,36,19
cell_r18_c9.png,18,9,538,317,570,336,32,19
cell_r18_c10.png,18,10,570,317,627,336,57,19
cell_r18_c11.png,18,11,627,317,698,336,71,19
cell_r18_c12.png,18,12,698,317,735,336,37,19
cell_r18_c13.png,18,13,735,317,767,336,32,19
cell_r18_c14.png,18,14,767,318,823,336,56,18
cell_r18_c15.png,18,15,823,318,888,337,65,19
cell_r18_c16.png,18,16,888,318,920,337,32,19
cell_r18_c17.png,18,17,920,318,986,338,66,20
cell_r18_c18.png,18,18,986,318,1051,338,65,20
cell_r18_c0.png,18,0,1,315,16,334,15,19
cell_r18_c1.png,18,1,16,316,228,334,212,18
cell_r18_c2.png,18,2,228,316,279,334,51,18
cell_r18_c3.png,18,3,279,316,323,335,44,19
cell_r18_c4.png,18,4,323,317,359,335,36,18
cell_r18_c5.png,18,5,359,316,391,336,32,20
cell_r18_c6.png,18,6,391,316,446,336,55,20
cell_r18_c7.png,18,7,446,316,502,335,56,19
cell_r18_c8.png,18,8,502,317,538,336,36,19
cell_r18_c9.png,18,9,538,317,570,336,32,19
cell_r18_c10.png,18,10,570,317,627,336,57,19
cell_r18_c11.png,18,11,627,317,698,336,71,19
cell_r18_c12.png,18,12,698,317,735,336,37,19
cell_r18_c13.png,18,13,735,317,767,336,32,19
cell_r18_c14.png,18,14,767,318,823,336,56,18
cell_r18_c15.png,18,15,823,318,888,337,65,19
cell_r18_c16.png,18,16,888,318,920,337,32,19
cell_r18_c17.png,18,17,920,318,986,338,66,20
cell_r18_c18.png,18,18,986,318,1051,338,65,20
cell_r18_c0.png,18,0,1,315,16,334,15,19
cell_r18_c1.png,18,1,16,316,228,334,212,18
cell_r18_c2.png,18,2,228,316,279,334,51,18
cell_r18_c3.png,18,3,279,316,323,335,44,19
cell_r18_c4.png,18,4,323,317,359,335,36,18
cell_r18_c5.png,18,5,359,316,391,336,32,20
cell_r18_c6.png,18,6,391,316,446,336,55,20
cell_r18_c7.png,18,7,446,316,502,335,56,19
cell_r18_c8.png,18,8,502,317,538,336,36,19
cell_r18_c9.png,18,9,538,317,570,336,32,19
cell_r18_c10.png,18,10,570,317,627,336,57,19
cell_r18_c11.png,18,11,627,317,698,336,71,19
cell_r18_c12.png,18,12,698,317,735,336,37,19
cell_r18_c13.png,18,13,735,317,767,336,32,19
cell_r18_c14.png,18,14,767,318,823,336,56,18
cell_r18_c15.png,18,15,823,318,888,337,65,19
cell_r18_c16.png,18,16,888,318,920,337,32,19
cell_r18_c17.png,18,17,920,318,986,338,66,20
cell_r18_c18.png,18,18,986,318,1051,338,65,20
cell_r18_c0.png,18,0,1,315,16,334,15,19
cell_r18_c1.png,18,1,16,316,228,334,212,18
cell_r18_c2.png,18,2,228,316,279,334,51,18
cell_r18_c3.png,18,3,279,316,323,335,44,19
cell_r18_c4.png,18,4,323,317,359,335,36,18
cell_r18_c5.png,18,5,359,316,391,336,32,20
cell_r18_c6.png,18,6,391,316,446,336,55,20
cell_r18_c7.png,18,7,446,316,502,335,56,19
cell_r18_c8.png,18,8,502,317,538,336,36,19
cell_r18_c9.png,18,9,538,317,570,336,32,19
cell_r18_c10.png,18,10,570,317,627,336,57,19
cell_r18_c11.png,18,11,627,317,698,336,71,19
cell_r18_c12.png,18,12,698,317,735,336,37,19
cell_r18_c13.png,18,13,735,317,767,336,32,19
cell_r18_c14.png,18,14,767,318,823,336,56,18
cell_r18_c15.png,18,15,823,318,888,337,65,19
cell_r18_c16.png,18,16,888,318,920,337,32,19
cell_r18_c17.png,18,17,920,318,986,338,66,20
cell_r18_c18.png,18,18,986,318,1051,338,65,20
cell_r18_c0.png,18,0,1,315,16,334,15,19
cell_r18_c1.png,18,1,16,316,228,334,212,18
cell_r18_c2.png,18,2,228,316,279,334,51,18
cell_r18_c3.png,18,3,279,316,323,335,44,19
cell_r18_c4.png,18,4,323,317,359,335,36,18
cell_r18_c5.png,18,5,359,316,391,336,32,20
cell_r18_c6.png,18,6,391,316,446,336,55,20
cell_r18_c7.png,18,7,446,316,502,335,56,19
cell_r18_c8.png,18,8,502,317,538,336,36,19
cell_r18_c9.png,18,9,538,317,570,336,32,19
cell_r18_c10.png,18,10,570,317,627,336,57,19
cell_r18_c11.png,18,11,627,317,698,336,71,19
cell_r18_c12.png,18,12,698,317,735,336,37,19
cell_r18_c13.png,18,13,735,317,767,336,32,19
cell_r18_c14.png,18,14,767,318,823,336,56,18
cell_r18_c15.png,18,15,823,318,888,337,65,19
cell_r18_c16.png,18,16,888,318,920,337,32,19
cell_r18_c17.png,18,17,920,318,986,338,66,20
cell_r18_c18.png,18,18,986,318,1051,338,65,20
cell_r18_c0.png,18,0,1,315,16,334,15,19
cell_r18_c1.png,18,1,16,316,228,334,212,18
cell_r18_c2.png,18,2,228,316,279,334,51,18
cell_r18_c3.png,18,3,279,316,323,335,44,19
cell_r18_c4.png,18,4,323,317,359,335,36,18
cell_r18_c5.png,18,5,359,316,391,336,32,20
cell_r18_c6.png,18,6,391,316,446,336,55,20
cell_r18_c7.png,18,7,446,316,502,335,56,19
cell_r18_c8.png,18,8,502,317,538,336,36,19
cell_r18_c9.png,18,9,538,317,570,336,32,19
cell_r18_c10.png,18,10,570,317,627,336,57,19
cell_r18_c11.png,18,11,627,317,698,336,71,19
cell_r18_c12.png,18,12,698,317,735,336,37,19
cell_r18_c13.png,18,13,735,317,767,336,32,19
cell_r18_c14.png,18,14,767,318,823,336,56,18
cell_r18_c15.png,18,15,823,318,888,337,65,19
cell_r18_c16.png,18,16,888,318,920,337,32,19
cell_r18_c17.png,18,17,920,318,986,338,66,20
cell_r18_c18.png,18,18,986,318,1051,338,65,20
cell_r18_c0.png,18,0,1,315,16,334,15,19
cell_r18_c1.png,18,1,16,316,228,334,212,18
cell_r18_c2.png,18,2,228,316,279,334,51,18
cell_r18_c3.png,18,3,279,316,323,335,44,19
cell_r18_c4.png,18,4,323,317,359,335,36,18
cell_r18_c5.png,18,5,359,316,391,336,32,20
cell_r18_c6.png,18,6,391,316,446,336,55,20
cell_r18_c7.png,18,7,446,316,502,335,56,19
cell_r18_c8.png,18,8,502,317,538,336,36,19
cell_r18_c9.png,18,9,538,317,570,336,32,19
cell_r18_c10.png,18,10,570,317,627,336,57,19
cell_r18_c11.png,18,11,627,317,698,336,71,19
cell_r18_c12.png,18,12,698,317,735,336,37,19
cell_r18_c13.png,18,13,735,317,767,336,32,19
cell_r18_c14.png,18,14,767,318,823,336,56,18
cell_r18_c15.png,18,15,823,318,888,337,65,19
cell_r18_c16.png,18,16,888,318,920,337,32,19
cell_r18_c17.png,18,17,920,318,986,338,66,20
cell_r18_c18.png,18,18,986,318,1051,338,65,20
cell_r18_c0.png,18,0,1,315,16,334,15,19
cell_r18_c1.png,18,1,16,316,228,334,212,18
cell_r18_c2.png,18,2,228,316,279,334,51,18
cell_r18_c3.png,18,3,279,316,323,335,44,19
cell_r18_c4.png,18,4,323,317,359,335,36,18
cell_r18_c5.png,18,5,359,316,391,336,32,20
cell_r18_c6.png,18,6,391,316,446,336,55,20
cell_r18_c7.png,18,7,446,316,502,335,56,19
cell_r18_c8.png,18,8,502,317,538,336,36,19
cell_r18_c9.png,18,9,538,317,570,336,32,19
cell_r18_c10.png,18,10,570,317,627,336,57,19
cell_r18_c11.png,18,11,627,317,698,336,71,19
cell_r18_c12.png,18,12,698,317,735,336,37,19
cell_r18_c13.png,18,13,735,317,767,336,32,19
cell_r18_c14.png,18,14,767,318,823,336,56,18
cell_r18_c15.png,18,15,823,318,888,337,65,19
cell_r18_c16.png,18,16,888,318,920,337,32,19
cell_r18_c17.png,18,17,920,318,986,338,66,20
cell_r18_c18.png,18,18,986,318,1051,338,65,20
cell_r18_c0.png,18,0,1,315,16,334,15,19
cell_r18_c1.png,18,1,16,316,228,334,212,18
cell_r18_c2.png,18,2,228,316,279,334,51,18
cell_r18_c3.png,18,3,279,316,323,335,44,19
cell_r18_c4.png,18,4,323,317,359,335,36,18
cell_r18_c5.png,18,5,359,316,391,336,32,20
cell_r18_c6.png,18,6,391,316,446,336,55,20
cell_r18_c7.png,18,7,446,316,502,335,56,19
cell_r18_c8.png,18,8,502,317,538,336,36,19
cell_r18_c9.png,18,9,538,317,570,336,32,19
cell_r18_c10.png,18,10,570,317,627,336,57,19
cell_r18_c11.png,18,11,627,317,698,336,71,19
cell_r18_c12.png,18,12,698,317,735,336,37,19
cell_r18_c13.png,18,13,735,317,767,336,32,19
cell_r18_c14.png,18,14,767,318,823,336,56,18
cell_r18_c15.png,18,15,823,318,888,337,65,19
cell_r18_c16.png,18,16,888,318,920,337,32,19
cell_r18_c17.png,18,17,920,318,986,338,66,20
cell_r18_c18.png,18,18,986,318,1051,338,65,20
cell_r18_c0.png,18,0,1,315,16,334,15,19
cell_r18_c1.png,18,1,16,316,228,334,212,18
cell_r18_c2.png,18,2,228,316,279,334,51,18
cell_r18_c3.png,18,3,279,316,323,335,44,19
cell_r18_c4.png,18,4,323,317,359,335,36,18
cell_r18_c5.png,18,5,359,316,391,336,32,20
cell_r18_c6.png,18,6,391,316,446,336,55,20
cell_r18_c7.png,18,7,446,316,502,335,56,19
cell_r18_c8.png,18,8,502,317,538,336,36,19
cell_r18_c9.png,18,9,538,317,570,336,32,19
cell_r18_c10.png,18,10,570,317,627,336,57,19
cell_r18_c11.png,18,11,627,317,698,336,71,19
cell_r18_c12.png,18,12,698,317,735,336,37,19
cell_r18_c13.png,18,13,735,317,767,336,32,19
cell_r18_c14.png,18,14,767,318,823,336,56,18
cell_r18_c15.png,18,15,823,318,888,337,65,19
cell_r18_c16.png,18,16,888,318,920,337,32,19
cell_r18_c17.png,18,17,920,318,986,338,66,20
cell_r18_c18.png,18,18,986,318,1051,338,65,20
cell_r18_c0.png,18,0,1,315,16,334,15,19
cell_r18_c1.png,18,1,16,316,228,334,212,18
cell_r18_c2.png,18,2,228,316,279,334,51,18
cell_r18_c3.png,18,3,279,316,323,335,44,19
cell_r18_c4.png,18,4,323,317,359,335,36,18
cell_r18_c5.png,18,5,359,316,391,336,32,20
cell_r18_c6.png,18,6,391,316,446,336,55,20
cell_r18_c7.png,18,7,446,316,502,335,56,19
cell_r18_c8.png,18,8,502,317,538,336,36,19
cell_r18_c9.png,18,9,538,317,570,336,32,19
cell_r18_c10.png,18,10,570,317,627,336,57,19
cell_r18_c11.png,18,11,627,317,698,336,71,19
cell_r18_c12.png,18,12,698,317,735,336,37,19
cell_r18_c13.png,18,13,735,317,767,336,32,19
cell_r18_c14.png,18,14,767,318,823,336,56,18
cell_r18_c15.png,18,15,823,318,888,337,65,19
cell_r18_c16.png,18,16,888,318,920,337,32,19
cell_r18_c17.png,18,17,920,318,986,338,66,20
cell_r18_c18.png,18,18,986,318,1051,338,65,20
cell_r18_c0.png,18,0,1,315,16,334,15,19
cell_r18_c1.png,18,1,16,316,228,334,212,18
cell_r18_c2.png,18,2,228,316,279,334,51,18
cell_r18_c3.png,18,3,279,316,323,335,44,19
cell_r18_c4.png,18,4,323,317,359,335,36,18
cell_r18_c5.png,18,5,359,316,391,336,32,20
cell_r18_c6.png,18,6,391,316,446,336,55,20
cell_r18_c7.png,18,7,446,316,502,335,56,19
cell_r18_c8.png,18,8,502,317,538,336,36,19
cell_r18_c9.png,18,9,538,317,570,336,32,19
cell_r18_c10.png,18,10,570,317,627,336,57,19
cell_r18_c11.png,18,11,627,317,698,336,71,19
cell_r18_c12.png,18,12,698,317,735,336,37,19
cell_r18_c13.png,18,13,735,317,767,336,32,19
cell_r18_c14.png,18,14,767,318,823,336,56,18
cell_r18_c15.png,18,15,823,318,888,337,65,19
cell_r18_c16.png,18,16,888,318,920,337,32,19
cell_r18_c17.png,18,17,920,318,986,338,66,20
cell_r18_c18.png,18,18,986,318,1051,338,65,20
cell_r18_c0.png,18,0,1,315,16,334,15,19
cell_r18_c1.png,18,1,16,316,228,334,212,18
cell_r18_c2.png,18,2,228,316,279,334,51,18
cell_r18_c3.png,18,3,279,316,323,335,44,19
cell_r18_c4.png,18,4,323,317,359,335,36,18
cell_r18_c5.png,18,5,359,316,391,336,32,20
cell_r18_c6.png,18,6,391,316,446,336,55,20
cell_r18_c7.png,18,7,446,316,502,335,56,19
cell_r18_c8.png,18,8,502,317,538,336,36,19
cell_r18_c9.png,18,9,538,317,570,336,32,19
cell_r18_c10.png,18,10,570,317,627,336,57,19
cell_r18_c11.png,18,11,627,317,698,336,71,19
cell_r18_c12.png,18,12,698,317,735,336,37,19
cell_r18_c13.png,18,13,735,317,767,336,32,19
cell_r18_c14.png,18,14,767,318,823,336,56,18
cell_r18_c15.png,18,15,823,318,888,337,65,19
cell_r18_c16.png,18,16,888,318,920,337,32,19
cell_r18_c17.png,18,17,920,318,986,338,66,20
cell_r18_c18.png,18,18,986,318,1051,338,65,20
cell_r18_c0.png,18,0,1,315,16,334,15,19
cell_r18_c1.png,18,1,16,316,228,334,212,18
cell_r18_c2.png,18,2,228,316,279,334,51,18
cell_r18_c3.png,18,3,279,316,323,335,44,19
cell_r18_c4.png,18,4,323,317,359,335,36,18
cell_r18_c5.png,18,5,359,316,391,336,32,20
cell_r18_c6.png,18,6,391,316,446,336,55,20
cell_r18_c7.png,18,7,446,316,502,335,56,19
cell_r18_c8.png,18,8,502,317,538,336,36,19
cell_r18_c9.png,18,9,538,317,570,336,32,19
cell_r18_c10.png,18,10,570,317,627,336,57,19
cell_r18_c11.png,18,11,627,317,698,336,71,19
cell_r18_c12.png,18,12,698,317,735,336,37,19
cell_r18_c13.png,18,13,735,317,767,336,32,19
cell_r18_c14.png,18,14,767,318,823,336,56,18
cell_r18_c15.png,18,15,823,318,888,337,65,19
cell_r18_c16.png,18,16,888,318,920,337,32,19
cell_r18_c17.png,18,17,920,318,986,338,66,20
cell_r18_c18.png,18,18,986,318,1051,338,65,20
cell_r18_c0.png,18,0,1,315,16,334,15,19
cell_r18_c1.png,18,1,16,316,228,334,212,18
cell_r18_c2.png,18,2,228,316,279,334,51,18
cell_r18_c3.png,18,3,279,316,323,335,44,19
cell_r18_c4.png,18,4,323,317,359,335,36,18
cell_r18_c5.png,18,5,359,316,391,336,32,20
cell_r18_c6.png,18,6,391,316,446,336,55,20
cell_r18_c7.png,18,7,446,316,502,335,56,19
cell_r18_c8.png,18,8,502,317,538,336,36,19
cell_r18_c9.png,18,9,538,317,570,336,32,19
cell_r18_c10.png,18,10,570,317,627,336,57,19
cell_r18_c11.png,18,11,627,317,698,336,71,19
cell_r18_c12.png,18,12,698,317,735,336,37,19
cell_r18_c13.png,18,13,735,317,767,336,32,19
cell_r18_c14.png,18,14,767,318,823,336,56,18
cell_r18_c15.png,18,15,823,318,888,337,65,19
cell_r18_c16.png,18,16,888,318,920,337,32,19
cell_r18_c17.png,18,17,920,318,986,338,66,20
cell_r18_c18.png,18,18,986,318,1051,338,65,20
cell_r18_c0.png,18,0,1,315,16,334,15,19
cell_r18_c1.png,18,1,16,316,228,334,212,18
cell_r18_c2.png,18,2,228,316,279,334,51,18
cell_r18_c3.png,18,3,279,316,323,335,44,19
cell_r18_c4.png,18,4,323,317,359,335,36,18
cell_r18_c5.png,18,5,359,316,391,336,32,20
cell_r18_c6.png,18,6,391,316,446,336,55,20
cell_r18_c7.png,18,7,446,316,502,335,56,19
cell_r18_c8.png,18,8,502,317,538,336,36,19
cell_r18_c9.png,18,9,538,317,570,336,32,19
cell_r18_c10.png,18,10,570,317,627,336,57,19
cell_r18_c11.png,18,11,627,317,698,336,71,19
cell_r18_c12.png,18,12,698,317,735,336,37,19
cell_r18_c13.png,18,13,735,317,767,336,32,19
cell_r18_c14.png,18,14,767,318,823,336,56,18
cell_r18_c15.png,18,15,823,318,888,337,65,19
cell_r18_c16.png,18,16,888,318,920,337,32,19
cell_r18_c17.png,18,17,920,318,986,338,66,20
cell_r18_c18.png,18,18,986,318,1051,338,65,20
cell_r19_c0.png,19,0,1,334,16,346,15,12
cell_r19_c1.png,19,1,16,334,228,347,212,13
cell_r19_c2.png,19,2,228,334,279,347,51,13
cell_r19_c3.png,19,3,279,334,323,348,44,14
cell_r19_c4.png,19,4,323,335,359,348,36,13
cell_r19_c5.png,19,5,359,335,391,348,32,13
cell_r19_c6.png,19,6,391,335,446,348,55,13
cell_r19_c7.png,19,7,446,335,502,348,56,13
cell_r19_c8.png,19,8,502,335,538,348,36,13
cell_r19_c9.png,19,9,538,336,570,348,32,12
cell_r19_c10.png,19,10,570,336,627,349,57,13
cell_r19_c11.png,19,11,627,336,698,349,71,13
cell_r19_c12.png,19,12,698,336,735,349,37,13
cell_r19_c13.png,19,13,735,336,767,349,32,13
cell_r19_c14.png,19,14,767,336,823,349,56,13
cell_r19_c15.png,19,15,823,336,888,350,65,14
cell_r19_c16.png,19,16,888,337,920,350,32,13
cell_r19_c17.png,19,17,920,337,987,350,67,13
cell_r19_c18.png,19,18,986,338,1051,350,65,12
cell_r19_c0.png,19,0,1,334,16,346,15,12
cell_r19_c1.png,19,1,16,334,228,347,212,13
cell_r19_c2.png,19,2,228,334,279,347,51,13
cell_r19_c3.png,19,3,279,334,323,348,44,14
cell_r19_c4.png,19,4,323,335,359,348,36,13
cell_r19_c5.png,19,5,359,335,391,348,32,13
cell_r19_c6.png,19,6,391,335,446,348,55,13
cell_r19_c7.png,19,7,446,335,502,348,56,13
cell_r19_c8.png,19,8,502,335,538,348,36,13
cell_r19_c9.png,19,9,538,336,570,348,32,12
cell_r19_c10.png,19,10,570,336,627,349,57,13
cell_r19_c11.png,19,11,627,336,698,349,71,13
cell_r19_c12.png,19,12,698,336,735,349,37,13
cell_r19_c13.png,19,13,735,336,767,349,32,13
cell_r19_c14.png,19,14,767,336,823,349,56,13
cell_r19_c15.png,19,15,823,336,888,350,65,14
cell_r19_c16.png,19,16,888,337,920,350,32,13
cell_r19_c17.png,19,17,920,337,987,350,67,13
cell_r19_c18.png,19,18,986,338,1051,350,65,12
cell_r19_c0.png,19,0,1,334,16,346,15,12
cell_r19_c1.png,19,1,16,334,228,347,212,13
cell_r19_c2.png,19,2,228,334,279,347,51,13
cell_r19_c3.png,19,3,279,334,323,348,44,14
cell_r19_c4.png,19,4,323,335,359,348,36,13
cell_r19_c5.png,19,5,359,335,391,348,32,13
cell_r19_c6.png,19,6,391,335,446,348,55,13
cell_r19_c7.png,19,7,446,335,502,348,56,13
cell_r19_c8.png,19,8,502,335,538,348,36,13
cell_r19_c9.png,19,9,538,336,570,348,32,12
cell_r19_c10.png,19,10,570,336,627,349,57,13
cell_r19_c11.png,19,11,627,336,698,349,71,13
cell_r19_c12.png,19,12,698,336,735,349,37,13
cell_r19_c13.png,19,13,735,336,767,349,32,13
cell_r19_c14.png,19,14,767,336,823,349,56,13
cell_r19_c15.png,19,15,823,336,888,350,65,14
cell_r19_c16.png,19,16,888,337,920,350,32,13
cell_r19_c17.png,19,17,920,337,987,350,67,13
cell_r19_c18.png,19,18,986,338,1051,350,65,12
cell_r19_c0.png,19,0,1,334,16,346,15,12
cell_r19_c1.png,19,1,16,334,228,347,212,13
cell_r19_c2.png,19,2,228,334,279,347,51,13
cell_r19_c3.png,19,3,279,334,323,348,44,14
cell_r19_c4.png,19,4,323,335,359,348,36,13
cell_r19_c5.png,19,5,359,335,391,348,32,13
cell_r19_c6.png,19,6,391,335,446,348,55,13
cell_r19_c7.png,19,7,446,335,502,348,56,13
cell_r19_c8.png,19,8,502,335,538,348,36,13
cell_r19_c9.png,19,9,538,336,570,348,32,12
cell_r19_c10.png,19,10,570,336,627,349,57,13
cell_r19_c11.png,19,11,627,336,698,349,71,13
cell_r19_c12.png,19,12,698,336,735,349,37,13
cell_r19_c13.png,19,13,735,336,767,349,32,13
cell_r19_c14.png,19,14,767,336,823,349,56,13
cell_r19_c15.png,19,15,823,336,888,350,65,14
cell_r19_c16.png,19,16,888,337,920,350,32,13
cell_r19_c17.png,19,17,920,337,987,350,67,13
cell_r19_c18.png,19,18,986,338,1051,350,65,12
cell_r19_c0.png,19,0,1,334,16,346,15,12
cell_r19_c1.png,19,1,16,334,228,347,212,13
cell_r19_c2.png,19,2,228,334,279,347,51,13
cell_r19_c3.png,19,3,279,334,323,348,44,14
cell_r19_c4.png,19,4,323,335,359,348,36,13
cell_r19_c5.png,19,5,359,335,391,348,32,13
cell_r19_c6.png,19,6,391,335,446,348,55,13
cell_r19_c7.png,19,7,446,335,502,348,56,13
cell_r19_c8.png,19,8,502,335,538,348,36,13
cell_r19_c9.png,19,9,538,336,570,348,32,12
cell_r19_c10.png,19,10,570,336,627,349,57,13
cell_r19_c11.png,19,11,627,336,698,349,71,13
cell_r19_c12.png,19,12,698,336,735,349,37,13
cell_r19_c13.png,19,13,735,336,767,349,32,13
cell_r19_c14.png,19,14,767,336,823,349,56,13
cell_r19_c15.png,19,15,823,336,888,350,65,14
cell_r19_c16.png,19,16,888,337,920,350,32,13
cell_r19_c17.png,19,17,920,337,987,350,67,13
cell_r19_c18.png,19,18,986,338,1051,350,65,12
cell_r19_c0.png,19,0,1,334,16,346,15,12
cell_r19_c1.png,19,1,16,334,228,347,212,13
cell_r19_c2.png,19,2,228,334,279,347,51,13
cell_r19_c3.png,19,3,279,334,323,348,44,14
cell_r19_c4.png,19,4,323,335,359,348,36,13
cell_r19_c5.png,19,5,359,335,391,348,32,13
cell_r19_c6.png,19,6,391,335,446,348,55,13
cell_r19_c7.png,19,7,446,335,502,348,56,13
cell_r19_c8.png,19,8,502,335,538,348,36,13
cell_r19_c9.png,19,9,538,336,570,348,32,12
cell_r19_c10.png,19,10,570,336,627,349,57,13
cell_r19_c11.png,19,11,627,336,698,349,71,13
cell_r19_c12.png,19,12,698,336,735,349,37,13
cell_r19_c13.png,19,13,735,336,767,349,32,13
cell_r19_c14.png,19,14,767,336,823,349,56,13
cell_r19_c15.png,19,15,823,336,888,350,65,14
cell_r19_c16.png,19,16,888,337,920,350,32,13
cell_r19_c17.png,19,17,920,337,987,350,67,13
cell_r19_c18.png,19,18,986,338,1051,350,65,12
cell_r19_c0.png,19,0,1,334,16,346,15,12
cell_r19_c1.png,19,1,16,334,228,347,212,13
cell_r19_c2.png,19,2,228,334,279,347,51,13
cell_r19_c3.png,19,3,279,334,323,348,44,14
cell_r19_c4.png,19,4,323,335,359,348,36,13
cell_r19_c5.png,19,5,359,335,391,348,32,13
cell_r19_c6.png,19,6,391,335,446,348,55,13
cell_r19_c7.png,19,7,446,335,502,348,56,13
cell_r19_c8.png,19,8,502,335,538,348,36,13
cell_r19_c9.png,19,9,538,336,570,348,32,12
cell_r19_c10.png,19,10,570,336,627,349,57,13
cell_r19_c11.png,19,11,627,336,698,349,71,13
cell_r19_c12.png,19,12,698,336,735,349,37,13
cell_r19_c13.png,19,13,735,336,767,349,32,13
cell_r19_c14.png,19,14,767,336,823,349,56,13
cell_r19_c15.png,19,15,823,336,888,350,65,14
cell_r19_c16.png,19,16,888,337,920,350,32,13
cell_r19_c17.png,19,17,920,337,987,350,67,13
cell_r19_c18.png,19,18,986,338,1051,350,65,12
cell_r19_c0.png,19,0,1,334,16,346,15,12
cell_r19_c1.png,19,1,16,334,228,347,212,13
cell_r19_c2.png,19,2,228,334,279,347,51,13
cell_r19_c3.png,19,3,279,334,323,348,44,14
cell_r19_c4.png,19,4,323,335,359,348,36,13
cell_r19_c5.png,19,5,359,335,391,348,32,13
cell_r19_c6.png,19,6,391,335,446,348,55,13
cell_r19_c7.png,19,7,446,335,502,348,56,13
cell_r19_c8.png,19,8,502,335,538,348,36,13
cell_r19_c9.png,19,9,538,336,570,348,32,12
cell_r19_c10.png,19,10,570,336,627,349,57,13
cell_r19_c11.png,19,11,627,336,698,349,71,13
cell_r19_c12.png,19,12,698,336,735,349,37,13
cell_r19_c13.png,19,13,735,336,767,349,32,13
cell_r19_c14.png,19,14,767,336,823,349,56,13
cell_r19_c15.png,19,15,823,336,888,350,65,14
cell_r19_c16.png,19,16,888,337,920,350,32,13
cell_r19_c17.png,19,17,920,337,987,350,67,13
cell_r19_c18.png,19,18,986,338,1051,350,65,12
cell_r19_c0.png,19,0,1,334,16,346,15,12
cell_r19_c1.png,19,1,16,334,228,347,212,13
cell_r19_c2.png,19,2,228,334,279,347,51,13
cell_r19_c3.png,19,3,279,334,323,348,44,14
cell_r19_c4.png,19,4,323,335,359,348,36,13
cell_r19_c5.png,19,5,359,335,391,348,32,13
cell_r19_c6.png,19,6,391,335,446,348,55,13
cell_r19_c7.png,19,7,446,335,502,348,56,13
cell_r19_c8.png,19,8,502,335,538,348,36,13
cell_r19_c9.png,19,9,538,336,570,348,32,12
cell_r19_c10.png,19,10,570,336,627,349,57,13
cell_r19_c11.png,19,11,627,336,698,349,71,13
cell_r19_c12.png,19,12,698,336,735,349,37,13
cell_r19_c13.png,19,13,735,336,767,349,32,13
cell_r19_c14.png,19,14,767,336,823,349,56,13
cell_r19_c15.png,19,15,823,336,888,350,65,14
cell_r19_c16.png,19,16,888,337,920,350,32,13
cell_r19_c17.png,19,17,920,337,987,350,67,13
cell_r19_c18.png,19,18,986,338,1051,350,65,12
cell_r19_c0.png,19,0,1,334,16,346,15,12
cell_r19_c1.png,19,1,16,334,228,347,212,13
cell_r19_c2.png,19,2,228,334,279,347,51,13
cell_r19_c3.png,19,3,279,334,323,348,44,14
cell_r19_c4.png,19,4,323,335,359,348,36,13
cell_r19_c5.png,19,5,359,335,391,348,32,13
cell_r19_c6.png,19,6,391,335,446,348,55,13
cell_r19_c7.png,19,7,446,335,502,348,56,13
cell_r19_c8.png,19,8,502,335,538,348,36,13
cell_r19_c9.png,19,9,538,336,570,348,32,12
cell_r19_c10.png,19,10,570,336,627,349,57,13
cell_r19_c11.png,19,11,627,336,698,349,71,13
cell_r19_c12.png,19,12,698,336,735,349,37,13
cell_r19_c13.png,19,13,735,336,767,349,32,13
cell_r19_c14.png,19,14,767,336,823,349,56,13
cell_r19_c15.png,19,15,823,336,888,350,65,14
cell_r19_c16.png,19,16,888,337,920,350,32,13
cell_r19_c17.png,19,17,920,337,987,350,67,13
cell_r19_c18.png,19,18,986,338,1051,350,65,12
cell_r19_c0.png,19,0,1,334,16,346,15,12
cell_r19_c1.png,19,1,16,334,228,347,212,13
cell_r19_c2.png,19,2,228,334,279,347,51,13
cell_r19_c3.png,19,3,279,334,323,348,44,14
cell_r19_c4.png,19,4,323,335,359,348,36,13
cell_r19_c5.png,19,5,359,335,391,348,32,13
cell_r19_c6.png,19,6,391,335,446,348,55,13
cell_r19_c7.png,19,7,446,335,502,348,56,13
cell_r19_c8.png,19,8,502,335,538,348,36,13
cell_r19_c9.png,19,9,538,336,570,348,32,12
cell_r19_c10.png,19,10,570,336,627,349,57,13
cell_r19_c11.png,19,11,627,336,698,349,71,13
cell_r19_c12.png,19,12,698,336,735,349,37,13
cell_r19_c13.png,19,13,735,336,767,349,32,13
cell_r19_c14.png,19,14,767,336,823,349,56,13
cell_r19_c15.png,19,15,823,336,888,350,65,14
cell_r19_c16.png,19,16,888,337,920,350,32,13
cell_r19_c17.png,19,17,920,337,987,350,67,13
cell_r19_c18.png,19,18,986,338,1051,350,65,12
cell_r19_c0.png,19,0,1,334,16,346,15,12
cell_r19_c1.png,19,1,16,334,228,347,212,13
cell_r19_c2.png,19,2,228,334,279,347,51,13
cell_r19_c3.png,19,3,279,334,323,348,44,14
cell_r19_c4.png,19,4,323,335,359,348,36,13
cell_r19_c5.png,19,5,359,335,391,348,32,13
cell_r19_c6.png,19,6,391,335,446,348,55,13
cell_r19_c7.png,19,7,446,335,502,348,56,13
cell_r19_c8.png,19,8,502,335,538,348,36,13
cell_r19_c9.png,19,9,538,336,570,348,32,12
cell_r19_c10.png,19,10,570,336,627,349,57,13
cell_r19_c11.png,19,11,627,336,698,349,71,13
cell_r19_c12.png,19,12,698,336,735,349,37,13
cell_r19_c13.png,19,13,735,336,767,349,32,13
cell_r19_c14.png,19,14,767,336,823,349,56,13
cell_r19_c15.png,19,15,823,336,888,350,65,14
cell_r19_c16.png,19,16,888,337,920,350,32,13
cell_r19_c17.png,19,17,920,337,987,350,67,13
cell_r19_c18.png,19,18,986,338,1051,350,65,12
cell_r19_c0.png,19,0,1,334,16,346,15,12
cell_r19_c1.png,19,1,16,334,228,347,212,13
cell_r19_c2.png,19,2,228,334,279,347,51,13
cell_r19_c3.png,19,3,279,334,323,348,44,14
cell_r19_c4.png,19,4,323,335,359,348,36,13
cell_r19_c5.png,19,5,359,335,391,348,32,13
cell_r19_c6.png,19,6,391,335,446,348,55,13
cell_r19_c7.png,19,7,446,335,502,348,56,13
cell_r19_c8.png,19,8,502,335,538,348,36,13
cell_r19_c9.png,19,9,538,336,570,348,32,12
cell_r19_c10.png,19,10,570,336,627,349,57,13
cell_r19_c11.png,19,11,627,336,698,349,71,13
cell_r19_c12.png,19,12,698,336,735,349,37,13
cell_r19_c13.png,19,13,735,336,767,349,32,13
cell_r19_c14.png,19,14,767,336,823,349,56,13
cell_r19_c15.png,19,15,823,336,888,350,65,14
cell_r19_c16.png,19,16,888,337,920,350,32,13
cell_r19_c17.png,19,17,920,337,987,350,67,13
cell_r19_c18.png,19,18,986,338,1051,350,65,12
cell_r19_c0.png,19,0,1,334,16,346,15,12
cell_r19_c1.png,19,1,16,334,228,347,212,13
cell_r19_c2.png,19,2,228,334,279,347,51,13
cell_r19_c3.png,19,3,279,334,323,348,44,14
cell_r19_c4.png,19,4,323,335,359,348,36,13
cell_r19_c5.png,19,5,359,335,391,348,32,13
cell_r19_c6.png,19,6,391,335,446,348,55,13
cell_r19_c7.png,19,7,446,335,502,348,56,13
cell_r19_c8.png,19,8,502,335,538,348,36,13
cell_r19_c9.png,19,9,538,336,570,348,32,12
cell_r19_c10.png,19,10,570,336,627,349,57,13
cell_r19_c11.png,19,11,627,336,698,349,71,13
cell_r19_c12.png,19,12,698,336,735,349,37,13
cell_r19_c13.png,19,13,735,336,767,349,32,13
cell_r19_c14.png,19,14,767,336,823,349,56,13
cell_r19_c15.png,19,15,823,336,888,350,65,14
cell_r19_c16.png,19,16,888,337,920,350,32,13
cell_r19_c17.png,19,17,920,337,987,350,67,13
cell_r19_c18.png,19,18,986,338,1051,350,65,12
cell_r19_c0.png,19,0,1,334,16,346,15,12
cell_r19_c1.png,19,1,16,334,228,347,212,13
cell_r19_c2.png,19,2,228,334,279,347,51,13
cell_r19_c3.png,19,3,279,334,323,348,44,14
cell_r19_c4.png,19,4,323,335,359,348,36,13
cell_r19_c5.png,19,5,359,335,391,348,32,13
cell_r19_c6.png,19,6,391,335,446,348,55,13
cell_r19_c7.png,19,7,446,335,502,348,56,13
cell_r19_c8.png,19,8,502,335,538,348,36,13
cell_r19_c9.png,19,9,538,336,570,348,32,12
cell_r19_c10.png,19,10,570,336,627,349,57,13
cell_r19_c11.png,19,11,627,336,698,349,71,13
cell_r19_c12.png,19,12,698,336,735,349,37,13
cell_r19_c13.png,19,13,735,336,767,349,32,13
cell_r19_c14.png,19,14,767,336,823,349,56,13
cell_r19_c15.png,19,15,823,336,888,350,65,14
cell_r19_c16.png,19,16,888,337,920,350,32,13
cell_r19_c17.png,19,17,920,337,987,350,67,13
cell_r19_c18.png,19,18,986,338,1051,350,65,12
cell_r19_c0.png,19,0,1,334,16,346,15,12
cell_r19_c1.png,19,1,16,334,228,347,212,13
cell_r19_c2.png,19,2,228,334,279,347,51,13
cell_r19_c3.png,19,3,279,334,323,348,44,14
cell_r19_c4.png,19,4,323,335,359,348,36,13
cell_r19_c5.png,19,5,359,335,391,348,32,13
cell_r19_c6.png,19,6,391,335,446,348,55,13
cell_r19_c7.png,19,7,446,335,502,348,56,13
cell_r19_c8.png,19,8,502,335,538,348,36,13
cell_r19_c9.png,19,9,538,336,570,348,32,12
cell_r19_c10.png,19,10,570,336,627,349,57,13
cell_r19_c11.png,19,11,627,336,698,349,71,13
cell_r19_c12.png,19,12,698,336,735,349,37,13
cell_r19_c13.png,19,13,735,336,767,349,32,13
cell_r19_c14.png,19,14,767,336,823,349,56,13
cell_r19_c15.png,19,15,823,336,888,350,65,14
cell_r19_c16.png,19,16,888,337,920,350,32,13
cell_r19_c17.png,19,17,920,337,987,350,67,13
cell_r19_c18.png,19,18,986,338,1051,350,65,12
cell_r19_c0.png,19,0,1,334,16,346,15,12
cell_r19_c1.png,19,1,16,334,228,347,212,13
cell_r19_c2.png,19,2,228,334,279,347,51,13
cell_r19_c3.png,19,3,279,334,323,348,44,14
cell_r19_c4.png,19,4,323,335,359,348,36,13
cell_r19_c5.png,19,5,359,335,391,348,32,13
cell_r19_c6.png,19,6,391,335,446,348,55,13
cell_r19_c7.png,19,7,446,335,502,348,56,13
cell_r19_c8.png,19,8,502,335,538,348,36,13
cell_r19_c9.png,19,9,538,336,570,348,32,12
cell_r19_c10.png,19,10,570,336,627,349,57,13
cell_r19_c11.png,19,11,627,336,698,349,71,13
cell_r19_c12.png,19,12,698,336,735,349,37,13
cell_r19_c13.png,19,13,735,336,767,349,32,13
cell_r19_c14.png,19,14,767,336,823,349,56,13
cell_r19_c15.png,19,15,823,336,888,350,65,14
cell_r19_c16.png,19,16,888,337,920,350,32,13
cell_r19_c17.png,19,17,920,337,987,350,67,13
cell_r19_c18.png,19,18,986,338,1051,350,65,12
cell_r19_c0.png,19,0,1,334,16,346,15,12
cell_r19_c1.png,19,1,16,334,228,347,212,13
cell_r19_c2.png,19,2,228,334,279,347,51,13
cell_r19_c3.png,19,3,279,334,323,348,44,14
cell_r19_c4.png,19,4,323,335,359,348,36,13
cell_r19_c5.png,19,5,359,335,391,348,32,13
cell_r19_c6.png,19,6,391,335,446,348,55,13
cell_r19_c7.png,19,7,446,335,502,348,56,13
cell_r19_c8.png,19,8,502,335,538,348,36,13
cell_r19_c9.png,19,9,538,336,570,348,32,12
cell_r19_c10.png,19,10,570,336,627,349,57,13
cell_r19_c11.png,19,11,627,336,698,349,71,13
cell_r19_c12.png,19,12,698,336,735,349,37,13
cell_r19_c13.png,19,13,735,336,767,349,32,13
cell_r19_c14.png,19,14,767,336,823,349,56,13
cell_r19_c15.png,19,15,823,336,888,350,65,14
cell_r19_c16.png,19,16,888,337,920,350,32,13
cell_r19_c17.png,19,17,920,337,987,350,67,13
cell_r19_c18.png,19,18,986,338,1051,350,65,12
cell_r19_c0.png,19,0,1,334,16,346,15,12
cell_r19_c1.png,19,1,16,334,228,347,212,13
cell_r19_c2.png,19,2,228,334,279,347,51,13
cell_r19_c3.png,19,3,279,334,323,348,44,14
cell_r19_c4.png,19,4,323,335,359,348,36,13
cell_r19_c5.png,19,5,359,335,391,348,32,13
cell_r19_c6.png,19,6,391,335,446,348,55,13
cell_r19_c7.png,19,7,446,335,502,348,56,13
cell_r19_c8.png,19,8,502,335,538,348,36,13
cell_r19_c9.png,19,9,538,336,570,348,32,12
cell_r19_c10.png,19,10,570,336,627,349,57,13
cell_r19_c11.png,19,11,627,336,698,349,71,13
cell_r19_c12.png,19,12,698,336,735,349,37,13
cell_r19_c13.png,19,13,735,336,767,349,32,13
cell_r19_c14.png,19,14,767,336,823,349,56,13
cell_r19_c15.png,19,15,823,336,888,350,65,14
cell_r19_c16.png,19,16,888,337,920,350,32,13
cell_r19_c17.png,19,17,920,337,987,350,67,13
cell_r19_c18.png,19,18,986,338,1051,350,65,12
cell_r20_c0.png,20,0,1,346,16,365,15,19
cell_r20_c1.png,20,1,16,346,228,365,212,19
cell_r20_c2.png,20,2,228,347,279,365,51,18
cell_r20_c3.png,20,3,279,347,323,365,44,18
cell_r20_c4.png,20,4,323,348,359,365,36,17
cell_r20_c5.png,20,5,359,348,391,365,32,17
cell_r20_c6.png,20,6,391,348,446,365,55,17
cell_r20_c7.png,20,7,446,348,502,365,56,17
cell_r20_c8.png,20,8,502,348,538,365,36,17
cell_r20_c9.png,20,9,538,348,570,365,32,17
cell_r20_c10.png,20,10,570,348,627,365,57,17
cell_r20_c11.png,20,11,627,349,698,365,71,16
cell_r20_c12.png,20,12,698,349,735,365,37,16
cell_r20_c13.png,20,13,735,349,767,365,32,16
cell_r20_c14.png,20,14,767,349,823,365,56,16
cell_r20_c15.png,20,15,823,349,888,365,65,16
cell_r20_c16.png,20,16,888,350,920,365,32,15
cell_r20_c17.png,20,17,920,350,987,365,67,15
cell_r20_c18.png,20,18,987,350,1051,365,64,15
cell_r20_c0.png,20,0,1,346,16,365,15,19
cell_r20_c1.png,20,1,16,346,228,365,212,19
cell_r20_c2.png,20,2,228,347,279,365,51,18
cell_r20_c3.png,20,3,279,347,323,365,44,18
cell_r20_c4.png,20,4,323,348,359,365,36,17
cell_r20_c5.png,20,5,359,348,391,365,32,17
cell_r20_c6.png,20,6,391,348,446,365,55,17
cell_r20_c7.png,20,7,446,348,502,365,56,17
cell_r20_c8.png,20,8,502,348,538,365,36,17
cell_r20_c9.png,20,9,538,348,570,365,32,17
cell_r20_c10.png,20,10,570,348,627,365,57,17
cell_r20_c11.png,20,11,627,349,698,365,71,16
cell_r20_c12.png,20,12,698,349,735,365,37,16
cell_r20_c13.png,20,13,735,349,767,365,32,16
cell_r20_c14.png,20,14,767,349,823,365,56,16
cell_r20_c15.png,20,15,823,349,888,365,65,16
cell_r20_c16.png,20,16,888,350,920,365,32,15
cell_r20_c17.png,20,17,920,350,987,365,67,15
cell_r20_c18.png,20,18,987,350,1051,365,64,15
cell_r20_c0.png,20,0,1,346,16,365,15,19
cell_r20_c1.png,20,1,16,346,228,365,212,19
cell_r20_c2.png,20,2,228,347,279,365,51,18
cell_r20_c3.png,20,3,279,347,323,365,44,18
cell_r20_c4.png,20,4,323,348,359,365,36,17
cell_r20_c5.png,20,5,359,348,391,365,32,17
cell_r20_c6.png,20,6,391,348,446,365,55,17
cell_r20_c7.png,20,7,446,348,502,365,56,17
cell_r20_c8.png,20,8,502,348,538,365,36,17
cell_r20_c9.png,20,9,538,348,570,365,32,17
cell_r20_c10.png,20,10,570,348,627,365,57,17
cell_r20_c11.png,20,11,627,349,698,365,71,16
cell_r20_c12.png,20,12,698,349,735,365,37,16
cell_r20_c13.png,20,13,735,349,767,365,32,16
cell_r20_c14.png,20,14,767,349,823,365,56,16
cell_r20_c15.png,20,15,823,349,888,365,65,16
cell_r20_c16.png,20,16,888,350,920,365,32,15
cell_r20_c17.png,20,17,920,350,987,365,67,15
cell_r20_c18.png,20,18,987,350,1051,365,64,15
cell_r20_c0.png,20,0,1,346,16,365,15,19
cell_r20_c1.png,20,1,16,346,228,365,212,19
cell_r20_c2.png,20,2,228,347,279,365,51,18
cell_r20_c3.png,20,3,279,347,323,365,44,18
cell_r20_c4.png,20,4,323,348,359,365,36,17
cell_r20_c5.png,20,5,359,348,391,365,32,17
cell_r20_c6.png,20,6,391,348,446,365,55,17
cell_r20_c7.png,20,7,446,348,502,365,56,17
cell_r20_c8.png,20,8,502,348,538,365,36,17
cell_r20_c9.png,20,9,538,348,570,365,32,17
cell_r20_c10.png,20,10,570,348,627,365,57,17
cell_r20_c11.png,20,11,627,349,698,365,71,16
cell_r20_c12.png,20,12,698,349,735,365,37,16
cell_r20_c13.png,20,13,735,349,767,365,32,16
cell_r20_c14.png,20,14,767,349,823,365,56,16
cell_r20_c15.png,20,15,823,349,888,365,65,16
cell_r20_c16.png,20,16,888,350,920,365,32,15
cell_r20_c17.png,20,17,920,350,987,365,67,15
cell_r20_c18.png,20,18,987,350,1051,365,64,15
cell_r20_c0.png,20,0,1,346,16,365,15,19
cell_r20_c1.png,20,1,16,346,228,365,212,19
cell_r20_c2.png,20,2,228,347,279,365,51,18
cell_r20_c3.png,20,3,279,347,323,365,44,18
cell_r20_c4.png,20,4,323,348,359,365,36,17
cell_r20_c5.png,20,5,359,348,391,365,32,17
cell_r20_c6.png,20,6,391,348,446,365,55,17
cell_r20_c7.png,20,7,446,348,502,365,56,17
cell_r20_c8.png,20,8,502,348,538,365,36,17
cell_r20_c9.png,20,9,538,348,570,365,32,17
cell_r20_c10.png,20,10,570,348,627,365,57,17
cell_r20_c11.png,20,11,627,349,698,365,71,16
cell_r20_c12.png,20,12,698,349,735,365,37,16
cell_r20_c13.png,20,13,735,349,767,365,32,16
cell_r20_c14.png,20,14,767,349,823,365,56,16
cell_r20_c15.png,20,15,823,349,888,365,65,16
cell_r20_c16.png,20,16,888,350,920,365,32,15
cell_r20_c17.png,20,17,920,350,987,365,67,15
cell_r20_c18.png,20,18,987,350,1051,365,64,15
cell_r20_c0.png,20,0,1,346,16,365,15,19
cell_r20_c1.png,20,1,16,346,228,365,212,19
cell_r20_c2.png,20,2,228,347,279,365,51,18
cell_r20_c3.png,20,3,279,347,323,365,44,18
cell_r20_c4.png,20,4,323,348,359,365,36,17
cell_r20_c5.png,20,5,359,348,391,365,32,17
cell_r20_c6.png,20,6,391,348,446,365,55,17
cell_r20_c7.png,20,7,446,348,502,365,56,17
cell_r20_c8.png,20,8,502,348,538,365,36,17
cell_r20_c9.png,20,9,538,348,570,365,32,17
cell_r20_c10.png,20,10,570,348,627,365,57,17
cell_r20_c11.png,20,11,627,349,698,365,71,16
cell_r20_c12.png,20,12,698,349,735,365,37,16
cell_r20_c13.png,20,13,735,349,767,365,32,16
cell_r20_c14.png,20,14,767,349,823,365,56,16
cell_r20_c15.png,20,15,823,349,888,365,65,16
cell_r20_c16.png,20,16,888,350,920,365,32,15
cell_r20_c17.png,20,17,920,350,987,365,67,15
cell_r20_c18.png,20,18,987,350,1051,365,64,15
cell_r20_c0.png,20,0,1,346,16,365,15,19
cell_r20_c1.png,20,1,16,346,228,365,212,19
cell_r20_c2.png,20,2,228,347,279,365,51,18
cell_r20_c3.png,20,3,279,347,323,365,44,18
cell_r20_c4.png,20,4,323,348,359,365,36,17
cell_r20_c5.png,20,5,359,348,391,365,32,17
cell_r20_c6.png,20,6,391,348,446,365,55,17
cell_r20_c7.png,20,7,446,348,502,365,56,17
cell_r20_c8.png,20,8,502,348,538,365,36,17
cell_r20_c9.png,20,9,538,348,570,365,32,17
cell_r20_c10.png,20,10,570,348,627,365,57,17
cell_r20_c11.png,20,11,627,349,698,365,71,16
cell_r20_c12.png,20,12,698,349,735,365,37,16
cell_r20_c13.png,20,13,735,349,767,365,32,16
cell_r20_c14.png,20,14,767,349,823,365,56,16
cell_r20_c15.png,20,15,823,349,888,365,65,16
cell_r20_c16.png,20,16,888,350,920,365,32,15
cell_r20_c17.png,20,17,920,350,987,365,67,15
cell_r20_c18.png,20,18,987,350,1051,365,64,15
cell_r20_c0.png,20,0,1,346,16,365,15,19
cell_r20_c1.png,20,1,16,346,228,365,212,19
cell_r20_c2.png,20,2,228,347,279,365,51,18
cell_r20_c3.png,20,3,279,347,323,365,44,18
cell_r20_c4.png,20,4,323,348,359,365,36,17
cell_r20_c5.png,20,5,359,348,391,365,32,17
cell_r20_c6.png,20,6,391,348,446,365,55,17
cell_r20_c7.png,20,7,446,348,502,365,56,17
cell_r20_c8.png,20,8,502,348,538,365,36,17
cell_r20_c9.png,20,9,538,348,570,365,32,17
cell_r20_c10.png,20,10,570,348,627,365,57,17
cell_r20_c11.png,20,11,627,349,698,365,71,16
cell_r20_c12.png,20,12,698,349,735,365,37,16
cell_r20_c13.png,20,13,735,349,767,365,32,16
cell_r20_c14.png,20,14,767,349,823,365,56,16
cell_r20_c15.png,20,15,823,349,888,365,65,16
cell_r20_c16.png,20,16,888,350,920,365,32,15
cell_r20_c17.png,20,17,920,350,987,365,67,15
cell_r20_c18.png,20,18,987,350,1051,365,64,15
cell_r20_c0.png,20,0,1,346,16,365,15,19
cell_r20_c1.png,20,1,16,346,228,365,212,19
cell_r20_c2.png,20,2,228,347,279,365,51,18
cell_r20_c3.png,20,3,279,347,323,365,44,18
cell_r20_c4.png,20,4,323,348,359,365,36,17
cell_r20_c5.png,20,5,359,348,391,365,32,17
cell_r20_c6.png,20,6,391,348,446,365,55,17
cell_r20_c7.png,20,7,446,348,502,365,56,17
cell_r20_c8.png,20,8,502,348,538,365,36,17
cell_r20_c9.png,20,9,538,348,570,365,32,17
cell_r20_c10.png,20,10,570,348,627,365,57,17
cell_r20_c11.png,20,11,627,349,698,365,71,16
cell_r20_c12.png,20,12,698,349,735,365,37,16
cell_r20_c13.png,20,13,735,349,767,365,32,16
cell_r20_c14.png,20,14,767,349,823,365,56,16
cell_r20_c15.png,20,15,823,349,888,365,65,16
cell_r20_c16.png,20,16,888,350,920,365,32,15
cell_r20_c17.png,20,17,920,350,987,365,67,15
cell_r20_c18.png,20,18,987,350,1051,365,64,15
cell_r20_c0.png,20,0,1,346,16,365,15,19
cell_r20_c1.png,20,1,16,346,228,365,212,19
cell_r20_c2.png,20,2,228,347,279,365,51,18
cell_r20_c3.png,20,3,279,347,323,365,44,18
cell_r20_c4.png,20,4,323,348,359,365,36,17
cell_r20_c5.png,20,5,359,348,391,365,32,17
cell_r20_c6.png,20,6,391,348,446,365,55,17
cell_r20_c7.png,20,7,446,348,502,365,56,17
cell_r20_c8.png,20,8,502,348,538,365,36,17
cell_r20_c9.png,20,9,538,348,570,365,32,17
cell_r20_c10.png,20,10,570,348,627,365,57,17
cell_r20_c11.png,20,11,627,349,698,365,71,16
cell_r20_c12.png,20,12,698,349,735,365,37,16
cell_r20_c13.png,20,13,735,349,767,365,32,16
cell_r20_c14.png,20,14,767,349,823,365,56,16
cell_r20_c15.png,20,15,823,349,888,365,65,16
cell_r20_c16.png,20,16,888,350,920,365,32,15
cell_r20_c17.png,20,17,920,350,987,365,67,15
cell_r20_c18.png,20,18,987,350,1051,365,64,15
cell_r20_c0.png,20,0,1,346,16,365,15,19
cell_r20_c1.png,20,1,16,346,228,365,212,19
cell_r20_c2.png,20,2,228,347,279,365,51,18
cell_r20_c3.png,20,3,279,347,323,365,44,18
cell_r20_c4.png,20,4,323,348,359,365,36,17
cell_r20_c5.png,20,5,359,348,391,365,32,17
cell_r20_c6.png,20,6,391,348,446,365,55,17
cell_r20_c7.png,20,7,446,348,502,365,56,17
cell_r20_c8.png,20,8,502,348,538,365,36,17
cell_r20_c9.png,20,9,538,348,570,365,32,17
cell_r20_c10.png,20,10,570,348,627,365,57,17
cell_r20_c11.png,20,11,627,349,698,365,71,16
cell_r20_c12.png,20,12,698,349,735,365,37,16
cell_r20_c13.png,20,13,735,349,767,365,32,16
cell_r20_c14.png,20,14,767,349,823,365,56,16
cell_r20_c15.png,20,15,823,349,888,365,65,16
cell_r20_c16.png,20,16,888,350,920,365,32,15
cell_r20_c17.png,20,17,920,350,987,365,67,15
cell_r20_c18.png,20,18,987,350,1051,365,64,15
cell_r20_c0.png,20,0,1,346,16,365,15,19
cell_r20_c1.png,20,1,16,346,228,365,212,19
cell_r20_c2.png,20,2,228,347,279,365,51,18
cell_r20_c3.png,20,3,279,347,323,365,44,18
cell_r20_c4.png,20,4,323,348,359,365,36,17
cell_r20_c5.png,20,5,359,348,391,365,32,17
cell_r20_c6.png,20,6,391,348,446,365,55,17
cell_r20_c7.png,20,7,446,348,502,365,56,17
cell_r20_c8.png,20,8,502,348,538,365,36,17
cell_r20_c9.png,20,9,538,348,570,365,32,17
cell_r20_c10.png,20,10,570,348,627,365,57,17
cell_r20_c11.png,20,11,627,349,698,365,71,16
cell_r20_c12.png,20,12,698,349,735,365,37,16
cell_r20_c13.png,20,13,735,349,767,365,32,16
cell_r20_c14.png,20,14,767,349,823,365,56,16
cell_r20_c15.png,20,15,823,349,888,365,65,16
cell_r20_c16.png,20,16,888,350,920,365,32,15
cell_r20_c17.png,20,17,920,350,987,365,67,15
cell_r20_c18.png,20,18,987,350,1051,365,64,15
cell_r20_c0.png,20,0,1,346,16,365,15,19
cell_r20_c1.png,20,1,16,346,228,365,212,19
cell_r20_c2.png,20,2,228,347,279,365,51,18
cell_r20_c3.png,20,3,279,347,323,365,44,18
cell_r20_c4.png,20,4,323,348,359,365,36,17
cell_r20_c5.png,20,5,359,348,391,365,32,17
cell_r20_c6.png,20,6,391,348,446,365,55,17
cell_r20_c7.png,20,7,446,348,502,365,56,17
cell_r20_c8.png,20,8,502,348,538,365,36,17
cell_r20_c9.png,20,9,538,348,570,365,32,17
cell_r20_c10.png,20,10,570,348,627,365,57,17
cell_r20_c11.png,20,11,627,349,698,365,71,16
cell_r20_c12.png,20,12,698,349,735,365,37,16
cell_r20_c13.png,20,13,735,349,767,365,32,16
cell_r20_c14.png,20,14,767,349,823,365,56,16
cell_r20_c15.png,20,15,823,349,888,365,65,16
cell_r20_c16.png,20,16,888,350,920,365,32,15
cell_r20_c17.png,20,17,920,350,987,365,67,15
cell_r20_c18.png,20,18,987,350,1051,365,64,15
cell_r20_c0.png,20,0,1,346,16,365,15,19
cell_r20_c1.png,20,1,16,346,228,365,212,19
cell_r20_c2.png,20,2,228,347,279,365,51,18
cell_r20_c3.png,20,3,279,347,323,365,44,18
cell_r20_c4.png,20,4,323,348,359,365,36,17
cell_r20_c5.png,20,5,359,348,391,365,32,17
cell_r20_c6.png,20,6,391,348,446,365,55,17
cell_r20_c7.png,20,7,446,348,502,365,56,17
cell_r20_c8.png,20,8,502,348,538,365,36,17
cell_r20_c9.png,20,9,538,348,570,365,32,17
cell_r20_c10.png,20,10,570,348,627,365,57,17
cell_r20_c11.png,20,11,627,349,698,365,71,16
cell_r20_c12.png,20,12,698,349,735,365,37,16
cell_r20_c13.png,20,13,735,349,767,365,32,16
cell_r20_c14.png,20,14,767,349,823,365,56,16
cell_r20_c15.png,20,15,823,349,888,365,65,16
cell_r20_c16.png,20,16,888,350,920,365,32,15
cell_r20_c17.png,20,17,920,350,987,365,67,15
cell_r20_c18.png,20,18,987,350,1051,365,64,15
cell_r20_c0.png,20,0,1,346,16,365,15,19
cell_r20_c1.png,20,1,16,346,228,365,212,19
cell_r20_c2.png,20,2,228,347,279,365,51,18
cell_r20_c3.png,20,3,279,347,323,365,44,18
cell_r20_c4.png,20,4,323,348,359,365,36,17
cell_r20_c5.png,20,5,359,348,391,365,32,17
cell_r20_c6.png,20,6,391,348,446,365,55,17
cell_r20_c7.png,20,7,446,348,502,365,56,17
cell_r20_c8.png,20,8,502,348,538,365,36,17
cell_r20_c9.png,20,9,538,348,570,365,32,17
cell_r20_c10.png,20,10,570,348,627,365,57,17
cell_r20_c11.png,20,11,627,349,698,365,71,16
cell_r20_c12.png,20,12,698,349,735,365,37,16
cell_r20_c13.png,20,13,735,349,767,365,32,16
cell_r20_c14.png,20,14,767,349,823,365,56,16
cell_r20_c15.png,20,15,823,349,888,365,65,16
cell_r20_c16.png,20,16,888,350,920,365,32,15
cell_r20_c17.png,20,17,920,350,987,365,67,15
cell_r20_c18.png,20,18,987,350,1051,365,64,15
cell_r20_c0.png,20,0,1,346,16,365,15,19
cell_r20_c1.png,20,1,16,346,228,365,212,19
cell_r20_c2.png,20,2,228,347,279,365,51,18
cell_r20_c3.png,20,3,279,347,323,365,44,18
cell_r20_c4.png,20,4,323,348,359,365,36,17
cell_r20_c5.png,20,5,359,348,391,365,32,17
cell_r20_c6.png,20,6,391,348,446,365,55,17
cell_r20_c7.png,20,7,446,348,502,365,56,17
cell_r20_c8.png,20,8,502,348,538,365,36,17
cell_r20_c9.png,20,9,538,348,570,365,32,17
cell_r20_c10.png,20,10,570,348,627,365,57,17
cell_r20_c11.png,20,11,627,349,698,365,71,16
cell_r20_c12.png,20,12,698,349,735,365,37,16
cell_r20_c13.png,20,13,735,349,767,365,32,16
cell_r20_c14.png,20,14,767,349,823,365,56,16
cell_r20_c15.png,20,15,823,349,888,365,65,16
cell_r20_c16.png,20,16,888,350,920,365,32,15
cell_r20_c17.png,20,17,920,350,987,365,67,15
cell_r20_c18.png,20,18,987,350,1051,365,64,15
cell_r20_c0.png,20,0,1,346,16,365,15,19
cell_r20_c1.png,20,1,16,346,228,365,212,19
cell_r20_c2.png,20,2,228,347,279,365,51,18
cell_r20_c3.png,20,3,279,347,323,365,44,18
cell_r20_c4.png,20,4,323,348,359,365,36,17
cell_r20_c5.png,20,5,359,348,391,365,32,17
cell_r20_c6.png,20,6,391,348,446,365,55,17
cell_r20_c7.png,20,7,446,348,502,365,56,17
cell_r20_c8.png,20,8,502,348,538,365,36,17
cell_r20_c9.png,20,9,538,348,570,365,32,17
cell_r20_c10.png,20,10,570,348,627,365,57,17
cell_r20_c11.png,20,11,627,349,698,365,71,16
cell_r20_c12.png,20,12,698,349,735,365,37,16
cell_r20_c13.png,20,13,735,349,767,365,32,16
cell_r20_c14.png,20,14,767,349,823,365,56,16
cell_r20_c15.png,20,15,823,349,888,365,65,16
cell_r20_c16.png,20,16,888,350,920,365,32,15
cell_r20_c17.png,20,17,920,350,987,365,67,15
cell_r20_c18.png,20,18,987,350,1051,365,64,15
cell_r20_c0.png,20,0,1,346,16,365,15,19
cell_r20_c1.png,20,1,16,346,228,365,212,19
cell_r20_c2.png,20,2,228,347,279,365,51,18
cell_r20_c3.png,20,3,279,347,323,365,44,18
cell_r20_c4.png,20,4,323,348,359,365,36,17
cell_r20_c5.png,20,5,359,348,391,365,32,17
cell_r20_c6.png,20,6,391,348,446,365,55,17
cell_r20_c7.png,20,7,446,348,502,365,56,17
cell_r20_c8.png,20,8,502,348,538,365,36,17
cell_r20_c9.png,20,9,538,348,570,365,32,17
cell_r20_c10.png,20,10,570,348,627,365,57,17
cell_r20_c11.png,20,11,627,349,698,365,71,16
cell_r20_c12.png,20,12,698,349,735,365,37,16
cell_r20_c13.png,20,13,735,349,767,365,32,16
cell_r20_c14.png,20,14,767,349,823,365,56,16
cell_r20_c15.png,20,15,823,349,888,365,65,16
cell_r20_c16.png,20,16,888,350,920,365,32,15
cell_r20_c17.png,20,17,920,350,987,365,67,15
cell_r20_c18.png,20,18,987,350,1051,365,64,15
cell_r20_c0.png,20,0,1,346,16,365,15,19
cell_r20_c1.png,20,1,16,346,228,365,212,19
cell_r20_c2.png,20,2,228,347,279,365,51,18
cell_r20_c3.png,20,3,279,347,323,365,44,18
cell_r20_c4.png,20,4,323,348,359,365,36,17
cell_r20_c5.png,20,5,359,348,391,365,32,17
cell_r20_c6.png,20,6,391,348,446,365,55,17
cell_r20_c7.png,20,7,446,348,502,365,56,17
cell_r20_c8.png,20,8,502,348,538,365,36,17
cell_r20_c9.png,20,9,538,348,570,365,32,17
cell_r20_c10.png,20,10,570,348,627,365,57,17
cell_r20_c11.png,20,11,627,349,698,365,71,16
cell_r20_c12.png,20,12,698,349,735,365,37,16
cell_r20_c13.png,20,13,735,349,767,365,32,16
cell_r20_c14.png,20,14,767,349,823,365,56,16
cell_r20_c15.png,20,15,823,349,888,365,65,16
cell_r20_c16.png,20,16,888,350,920,365,32,15
cell_r20_c17.png,20,17,920,350,987,365,67,15
cell_r20_c18.png,20,18,987,350,1051,365,64,15
